x
GCAGTCCTTCTN	NR4A1
ACGTAGGGGTAN	NFATC2
AAACAACCGAAN	CTRL
TCAGTGGCTTCT	CTRL
AGTATTCTCACN	CTRL
TTATAGCATGCA	CTRL
TACCTCGATTNN	RELB
GTTGCTTCGCNN	TUBB
CTGTCCAGTCNN	CTRL
GTCGTTTTAACN	CTRL
CGGTGGGCGCCT	FOS
TCTAGTGTGCNN	CTRL
CCGTCGTATCAN	RUNX2
TAAATGGTGTCN	PTPN11
GCTCGTGTGCCN	PTPN6
GCATATTTGCAG	NFKB1
CACTCCTTTGTN	LAT
CATTAGGTCTCA	ZAP70
TCCTTCCTGGCG	RUNX2
TGCCGTGGTTTN	EGR4
ACTTGACCCANN	BACH2
TTGGCCATTCCN	NR4A1
TTCTGATCATCT	NFATC2
TGCTAGCCGCAN	JUND
CAGGAACAAGNN	CTRL
GTTGGGTGGTNN	FOS
CCTACGGCCTNN	CTRL
ACTGGGACGCAA	CTRL
GCGGTTATGTCN	EGR1
GGTCCTTGTGGN	JUNB
CCTAGAGAATNN	NR4A1
TCCTGAGAATAN	NFATC3
GGCGGTGGGACN	CTRL
ATTCTGGGGTAN	REL
TGGCACATCTNN	FOS
GTTTCCTACCTN	PTPN6
ACCCACTATGNN	CTRL
GAGTCATACGNN	CTRL
ACGAGGTTCTTT	CTRL
CTTAGTCTTGTT	FOS
ATGTCGGAACNN	EGR1
GGAGCATGTTAN	RUNX2
TCACCTGTTTTN	NFATC1
ATGTCGGACNNN	EGR1
CGGTCGTTCGTN	ZAP70
ATGTCGGAGCNN	EGR1
GCCAGCATTTTC	CTRL
CCGACACCCANN	CTRL
GCCTTGTTCTNN	CTRL
GCCTTGTTCTAN	CTRL
TACCAGAAAGAN	CTRL
TACCAGAAAAGA	REL
GGTCAGGTGCCT	LAT
ATGCTCCTACCC	FOS
GGCCAATCTTNN	JUND
TCCTCGTACCGN	CTRL
AGGAATCCGTCA	NFATC1
CAACGTTACNNN	JUND
TGTAGGATAAGC	ZAP70
AACCCGTATANN	NFATC2
ACCTGTCACTGN	NFKB1
GACCAGATGACG	LAT
AAACCTAGGTGN	JUND
ACCAGTTTTCGC	NFATC1
AGACACAATCTN	CTRL
CCCTCGGACTAN	JUND
TTACTCTCACTN	NR4A1
CCACGAGAGANN	REL
GAAGAGGGCANN	NFKB2
ATCGCCCCCCNN	NFATC3
ATCGCCCCCCCC	NFATC3
ATCGCCCCCGCN	NFATC3
ATCGCCCCCGCC	NFATC3
TCGCCGGCGCCA	REL
AAGAGGGCANNN	NFKB1
TGATCGTTAACN	FOS
GTGTGATCACNN	PTPN11
GCTATTATAGTN	BACH2
AATTCGTCTGGN	DOK2
ACCTCAATCTCA	RELB
ATCGGCCCCGAN	JUNB
GTTCGCATGGGC	CTRL
GCTATTATGAGT	JUNB
TGATTATACTGN	NR4A1
GCACAGGCTTCA	EGR1
TAAACGCAGCTN	JUN
ACGGTGATCTNN	CTRL
CTGATGATTTGC	NFATC1
CTATGCTGATNN	NFATC1
CCAAGGTAACAN	PTPN11
ATCACATTANNN	REL
TTGCATGATTNN	ZAP70
ACGGTGATGCTN	NR4A1
TCTATGTGCNNN	CTRL
TTATCAGTCATN	NR4A1
GGCCTGATCCTN	DOK2
TCAAAAGTTCGT	EGR1
TGCCGTGATTTN	EGR4
ATTTACCTTGTN	EGR4
GACCTGCAACAN	NFATC1
ATGTCGAGTCTN	CTRL
CTGATATTTGCN	NFATC1
TCTTCATCCTGN	PTPN6
GACCTGCACANN	NFATC1
ATACCTCATTNN	RELB
AGCACTCCACGA	ZAP70
CTTATCTTGTTN	FOS
GTCGCGAGCAAN	REL
TCCTAGTGTGCN	CTRL
CAACCTTCCATN	PTPN6
CCGGCAATACCG	NFKB1
GCGACCATTCCG	RELB
GCGACCATTCCN	RELB
ATAAACATAACN	EGR4
ACAGCTATTTNN	TUBB
TGTTAGGCACTN	PTPN6
TTGGACATATTN	ZAP70
TCCAGAAAGANN	CTRL
GTTTAGGATTTC	BACH2
TGCCGTGTTTNN	EGR4
TGCTAGCGCANN	JUND
CTCCTTGGGGTC	CTRL
CCTACGGGACCT	CTRL
GATACGATTCCN	LCK
ATGCCGTTACTN	NFAT5
TGTTTATCTTAN	EGR4
GGTTACTTTTCC	LAT
GCGGTTTGTCNN	EGR1
GCCTTTCTANNN	CTRL
ACCTGTCCTGNN	CTRL
AATCCCGTTACC	NFAT5
TTTGAGCGGCGN	NFKB1
ATAACTTCGTCT	RUNX2
ACGCGTCTCTCN	EGR2
CGTCCCATTGCN	NFAT5
TGGCTAGCGCAN	JUND
GAGGGAACCGNN	NFATC1
GCGGGCCCCGCN	BACH2
CATTAGTCTCAN	ZAP70
AATGATGAAGCN	EGR3
GGCGTGGGACNN	CTRL
CCCTATTTANNN	JUN
CTTGTGAGTGGG	CTRL
AGGCAAGATGNN	CTRL
TTGACATGATTN	ZAP70
ACCAGATGACGN	LAT
AGGGTAAAATTC	PTPN6
TGATTATCTGNN	NR4A1
AGATGGGTCNNN	EGR1
GCTTTGGTTATG	JUNB
CTTGTCTTGTTN	FOS
ACAACGTTACNN	JUND
CATTTGGCTTCT	FOS
AAGCCCGGTANN	CTRL
CAGATCGTGGCG	JUND
GAACGGATACGA	NFATC1
AACACCGTATAN	NFATC2
CACTCCGTTTGT	LAT
GGGCAGCGCTGN	TUBB
GGGCAGCGCTNN	NFATC1
ATCAATTGTTTA	NFATC3
GGCGGTGCGGAC	CTRL
ACCATTGATCTT	RUNX2
GCTAGCTATTCN	ZAP70
CAGTCACTTCCT	MVD
GCGCCATTCCGN	RELB
CTTATGCCAGCN	NFATC1
GGACATGTGCTT	NR4A1
AAACCGTGAACA	CTRL
CTACATCTCCAN	JUND
TCCGTCGTATCA	RUNX2
TCCTAGTAGTGC	CTRL
CGACTACTCGAT	CTRL
CTAATAGCTTTN	CTRL
TCCTACTCGCTN	CTRL
CATTCCCTTAGN	NFKB2
ACCTGATGACNN	RELB
GCCTTTTCTANN	CTRL
GTCGAGTGGTGN	NFATC1
GGACGTATCAGA	DOK2
CACTGCGCGCTC	CTRL
CCTCACCCATAN	CTRL
TCCAGTGGCAGN	CTRL
CATTTCCCTTGN	NFKB2
CATTTCCCTTAG	NFKB2
GAATGTGCTTNN	NR4A1
CTTGCAGTTCNN	EGR1
GTCGAGTGTGNN	NFATC1
GCTTCATGCTTN	NFKB1
TGAGCTTTTCAN	NFAT5
AGGTTTTCCTNN	MVD
CGGCGGGTTCTT	CTRL
TCAGTGGTTCTN	CTRL
CTAGTCCCACTA	JUN
CGCGTGTTCCAN	NFKB2
CGTGCGATATGG	CTRL
GACGTGCCTAGA	CTRL
CAGCTTGGCNNN	ZAP70
GATCGCGTGCTC	PTPN11
GCCCAGTCTGNN	CTRL
TCGTGTGCTTCN	EGR2
CTTTCTTGTTNN	FOS
CCAGGATTAGCC	CTRL
GCGTCTTACANN	RELB
ATCGACATTANN	REL
TAGTGCTTCTNN	CTRL
ATCGACATTNNN	REL
TACGTGTCTTCN	EGR2
ACGGAGAATCTA	EGR2
GTCCTCGTACCG	CTRL
GTCCTCGTCCGN	CTRL
GCTAGTTGTGCN	FOS
TACGCGTCANNN	PTPN11
GCTCGTTGCCNN	PTPN6
CTGGACGGATGG	CTRL
AGTCATACGNNN	CTRL
CTCTTAAGATTN	RELB
TTGATGGGCACN	ZAP70
AATTGCCTAACN	CTRL
TAGTTCTCTNNN	EGR2
GTCAAGTATTNN	REL
TAGACGAACANN	CTRL
TATCTGGTAGGG	EGR3
TATCTGGTAGGN	EGR3
ATGTACAAACAN	REL
ACACAAGAGAAN	CTRL
ATGTACAACANN	REL
CACAATCCCTTN	FOS
CTATTATACTGN	CTRL
CCAGACTTTTNN	RUNX2
CCCTTGACTGCN	DOK2
GCACTAGCTCGN	JUND
ATTAGCATTATC	JUNB
ATTGACTGACTN	CTRL
TAAAGCGTTTCG	EGR4
CCGCTTGCANNN	LAT
GGGCTTTTTAAN	CTRL
ATTGTTTGATTN	NR4A1
TAACGCTGTCCT	GATA3
ACGCAGACTTTT	RUNX2
CCACAGTTGGGN	JUNB
GAGCTATATANN	EGR1
GTGATTTACTNN	EGR4
ACGACGTAACNN	NFATC2
CCGCACGCGTNN	EGR1
AAGATGTGGANN	CTRL
TAATACCCCGCN	DHODH
CACCCCTCCTGG	ZAP70
TAATGCTGAAGN	NFKB2
ATTTTCGGGCGN	LCK
TGGCTAATTTAA	RUNX1
CTGACACGGCTT	BACH2
GGGACTTTTTAA	CTRL
GAGAAGGTTCGN	PTPN6
GTCGTAGGCTTN	BACH2
TTTGCCAGAGCT	EGR1
TTCGACTTATNN	NFATC1
TAACGAACANNN	CTRL
CATATCTGCAAN	NFATC1
CCACTGTGTTTT	CTRL
AAATCCCTGTCC	NFKB1
TAGATACTTANN	FOS
CCATGCTGTCNN	ZAP70
CCGGCCATGCAT	PTPN11
ATTTTGTTTTTT	REL
ATTATATTGGTC	BACH2
CTATGGAAANNN	JUND
TCATGAGTAAAN	CTRL
TGCTGTCCTTNN	RELB
TTTGTTACACCA	CTRL
CACCCTCGTNNN	DOK2
TCCCTTGACTGC	DOK2
GGTGAAATCCGC	LAT
TCCCTCTCCCTG	CTRL
TCCCTCTCCCTN	CTRL
CTAATTCTCTNN	REL
CATGGTGTTTGN	JUN
TTTTGGTGGGNN	JUNB
CTCACGCCGTTN	NFATC2
GCTAACCAGTCN	CTRL
GCGCGAACTAGN	PTPN11
CACCTTAGAGNN	EGR4
GTTGAATAGGNN	CTRL
CTATGCACCTNN	BACH2
AATCAGGAGTTN	NFATC1
CTAATTCTGCTN	REL
ACCAGACTTTTN	RUNX2
AGACAAGAAGNN	NFKB2
AGGCCCCTATAN	EGR1
ACAGAGGCACCC	EGR1
GGTGATTTACTN	EGR4
GCCGCACGCGTN	EGR1
CCTGCCGCCCTC	JUNB
GGCTAACTATCC	ETS1
ACTGCCCGATCN	NFATC1
ATGTAGTTCCTA	NFATC1
CCAATGGCGAAC	RELB
GGAGGACGAGNN	DOK2
AAATAAGGAAAC	EGR2
AAAGCAGTCAAN	NR4A1
AAAGCAGTCAGA	RUNX2
CATAGATCCTTN	CTRL
ACCAGGACGGNN	REL
CCCACTCCTANN	ETS1
GGGAACACACTG	JUN
GTTAAATCTGTT	JUNB
GCTAACTATCCN	ETS1
GGTGGCTTTACN	NFKB2
ATTGCTGTATGA	CTRL
GTAAGGGCCAGN	CTRL
CCTCCAGACGGT	NFATC1
TACTACCCATNN	CTRL
CTAGGCACGCGT	DOK2
CTAGATACCCNN	FOS
AATGATCCCAGN	NR4A1
CGCCGATCCATN	NFKB1
TTTTAATTGGCN	CTRL
GGAAGGTTCGNN	PTPN6
TCTGGCGGCATN	NFATC1
CCTGAGATCCCN	FOS
TTGTTTCACANN	ZAP70
CCAGGCGTTTCA	NFATC2
CCTGAGATACCC	FOS
GAGCTAATATAN	EGR1
CTCCTACTTTTN	RUNX2
ACCAAGTAAACN	NR4A1
TAATACACCCGC	DHODH
CATTCAAACTCA	JUN
CCTTCGGTTTTN	NR4A1
GCCGAACCTAGN	PTPN11
CCCCACGGTGCC	BACH2
CCCGATCGAGCN	EGR1
CTCAAGGCCGGN	CTRL
GATCGATGGAAN	CTRL
GCCTGGCAAGNN	EGR1
TCGTCTGGACNN	NFKB1
CGGCGCACCANN	NFATC3
CGGCGCACCAGN	NFATC3
GCCAATGGGTNN	BACH2
TCATCTGTGGGN	PTPN6
CCTCTGTACGCA	RELA
CGCCCCCGTGTN	NR4A1
GCCTGCAAGNNN	EGR1
ATTGCTGTTGNN	CTRL
ATTGCTGTTGAN	CTRL
CCGTGCACTCCN	PTPN6
ACGGACGTAACN	NFATC2
CAACCTTAGAGN	EGR4
TTTGCGAGAANN	BACH2
GGACACGCAGAN	EGR1
CCTGAGGGGNNN	DOK2
TCGGCGTGACNN	NFKB1
AGGCATTTTANN	TUBB
ACTCGTTCTCTN	NFATC2
GCGTTGGCATAN	RELA
CCCTGAGGTCCC	NFATC1
TAGGGTAGCGAC	CTRL
CAACCACCCTGN	RUNX2
CAACCACCCTNN	RUNX2
CTATTCTGCTNN	REL
GCGTTGGCAGTA	RELA
TGTTTATACGTN	NFKB1
TGTTTATACGGT	JUND
CCGGGTGCAAGG	CTRL
TGTCCATAAGTN	CTRL
TCCAATATTTCN	JUNB
AAAGGGTAGGAN	DOK2
GGACATGGANNN	FOS
GGACACGCGGAN	EGR1
GTGTGTCAAANN	FOS
CAACACCTTTGT	JUNB
CATTTTAACAGA	LCK
CAGGCACGCGTN	DOK2
CCGTTCGAAGNN	NR4A1
GGGCAGATAGCA	NR4A1
CGTCCTACTTTT	RUNX2
CCATTCCTCANN	JUN
CAAACAATTCCG	NFAT5
GTCATCAAGCGN	LAT
AGAGTCTGCCTN	PTPN11
GGATCGTTGAAN	DOK2
GGATCGTTGAAA	DOK2
TTTTTTCGCATN	JUNB
CTTTGATCTTCN	DOK2
GGGTGGCGAAAN	JUND
ACCTCGACTGGN	FOS
AAATTGCCTAAC	CTRL
GGTCCGGGGANN	EGR4
GAATTCCTTTCA	CTRL
CCGAGCCGTACN	BACH2
CGTATCTCGCAC	RUNX2
TTGAATTGTANN	PTPN11
CCCCTCCTANNN	BACH2
TGTGTGATATCG	NFKB1
CTCCAATGTCNN	RUNX2
CATTACTCCTAC	NR4A1
GGGACGAGNNNN	DOK2
TAGACTTTTANN	NFAT5
GCGTGCTACTTA	NFATC3
CTATGCGACCTN	BACH2
GACAGCCATGNN	REL
ACCGGGACGGNN	REL
CCGCAGTAGCNN	EGR1
TTATGGGCACNN	ZAP70
TAAATGCTGAAG	NFKB2
TCCCTTGCTGCN	DOK2
CGCTGCTGTATA	CTRL
TACGCGCGATNN	RELA
TACGCGCGAGTN	RELA
GGAGAGCGCCNN	EGR4
CCTGGCCTCTAT	RUNX2
TAGCGTTTCCTN	CTRL
CCCGAGTCCCNN	NFATC1
CCAGCCCATTGN	JUNB
CCTGTTCGGGNN	NFKB2
CCTGTTCGGNNN	NFKB2
GTTTTTGTTAGN	EGR2
GCGGGTACTGAN	RUNX2
CCGTCCTGACNN	ZAP70
CGATGGTGTTTG	JUN
TTTCGGTTCATA	DOK2
TGTTTATTTCAN	RUNX2
CGTTATTACGAN	CTRL
TAAGGCCAGNNN	CTRL
CTCAGCCGTGNN	CTRL
GGTCAAGTATTN	REL
GTCCTCTCCNNN	NFKB1
CCTTCCTCANNN	JUN
TTAGACGAACAN	CTRL
CGTTATTAGCGA	CTRL
TTAAGGTTACAT	EGR4
TTTAGACACANN	EGR1
TTCCTCCCACAN	CTRL
TTAGACGACANN	CTRL
CCCAAACCTNNN	PTPN6
TCCAAGAGTATC	NFAT5
CTTCAACTCANN	JUN
CCACCCTCGTNN	DOK2
GGCAGATAGCAN	NR4A1
TGGAACCGAAGN	NFKB2
CCTCTTGCAANN	NR4A1
TCCCCGATTGCT	CTRL
GTTTCGCTTANN	NFKB1
TTACCTCGTGNN	NFATC1
GGTTTCTGAGNN	NFATC2
CTGCCGATCCAT	NFKB1
ACGCGTCACACC	CTRL
ACGCAAGTAAAC	NR4A1
TGGCAACCCATN	MVD
TGGCAACCACAT	MVD
TCTACGCGCNNN	CTRL
CCTGCTTGACAA	NR4A1
TTATGGCACNNN	ZAP70
TCATACTTGGNN	NFKB1
GTAAGGCCAGNN	CTRL
GTTATATCACGG	FOS
CCATTGCTGTCN	ZAP70
TGCAACCACATN	MVD
TCCCGATTGCTN	CTRL
TTGATGGCACNN	ZAP70
TTTGTCACCAGN	CTRL
CCTTGAGCGAGA	PTPN11
CCATGGCAATAN	CTRL
GCCGCGCCTCTN	MVD
CCTGGCAATANN	CTRL
CGTGTCCCCTCG	NFATC1
CGTGTCCCCTCN	NFATC1
ACGAATCGATNN	DOK2
CGTTATTTGGTN	NFAT5
GCGGTCATGCCA	CTRL
AGTCATCAAGCG	LAT
TTTGATATCGNN	NFKB1
GACTCAGATTCN	NFKB1
CTTTTGGCAGNN	EGR1
CACTTCGTGTTT	CTRL
GCAACTATCTGT	NFATC3
CGCGTCCACCNN	CTRL
CCTGCCTCTATN	RUNX2
TTATGTGAGGTN	NFKB1
CGTCATTCCTNN	LAT
TAGGCTAAAGTN	EGR1
GACTCAGTATTC	NFKB1
GGACTTTTTAAN	CTRL
ATTAGCGCGTAC	PTPN11
ACGCAGTAAACN	NR4A1
AATTGCTGACAN	CTRL
CCTTCGTTTTNN	NR4A1
TGCGGGTTAATN	EGR2
GACTCATGTTNN	RUNX1
GGCATTTTANNN	TUBB
ACGTGATTTCTA	ZAP70
GATCGGATACGN	NFKB1
GTATGTGTATNN	RELA
TTTCTTTACATG	PTPN6
TTTCTTTACATN	PTPN6
AGATGTGGANNN	CTRL
TTGTGTATATAG	PTPN6
CCGCAGATAGCN	EGR1
ACATCACGCGNN	DHODH
CGTGTCCCTCNN	NFATC1
CGTGTCCCTCGN	NFATC1
TCGTCCATAGTN	REL
TCGTCCATAAGT	CTRL
TCGTCCATAATN	CTRL
CTAGGCAGCGTN	DOK2
CCATCGCTGTTN	RELB
CCATCGCTGATT	RELB
CAATGGCGAACN	RUNX1
GTATATGGGTTN	RUNX2
TCTCTCCACATN	CTRL
GGAGAGGCGCCN	REL
TCAAACACCANN	CTRL
CCAATATTTCNN	JUNB
GAACAGGTGAAG	CTRL
GAGCGGGTGATT	DOK2
TCAAAACACCAN	CTRL
ACACAAGGAANN	CTRL
CCCTGAGTCCCN	NFATC1
GCGTGCTCTTAN	NFATC3
ACATCCTTCNNN	FOS
GGCCAATGGGTN	BACH2
CACTGTCTTCGT	PTPN11
TAATCTGTCAGN	JUND
CCCTTGCTCNNN	DOK2
ACTCCGTTCTCT	NR4A1
GCATAGTTGTTN	NR4A1
GCCAGTCCACCN	CTRL
TAAGCGTTCGNN	EGR4
CCTCTTTATCNN	JUN
GCTTGTGGACAA	JUNB
GATTGTGCGGCG	RELA
GCCTCACCTGTN	CTRL
TTCCATTCTCGN	JUNB
CTGTAATGCTGT	ZAP70
TATTCACATAGC	NFATC1
CTGCCTCTATNN	RUNX2
TACTCTGACGNN	FOS
TCCCCCGTCGGA	FOS
TCCCCCGTCGAN	FOS
GTCATATTTGTN	DOK2
TTGCGAGAANNN	BACH2
CGTTATTCTGGT	NFAT5
CGTTATTCTGTN	NFAT5
CCTCTTTTATCN	JUN
CCTAGATCCCNN	FOS
GCACTAGACTCG	JUND
AGTTATCTCCNN	FOS
CCGACAGTAGCN	EGR1
CCGATTCGAAGN	NR4A1
TGCAACCCATNN	MVD
CGCGAGACGCAC	EGR2
CGCTGCTTATAN	CTRL
ATCCCAGGTTTG	EGR3
CAGTAATGCGAN	CTRL
TTATGTAGGTNN	NFKB1
TAAGCGTTTCGN	EGR4
CTCGCCGCCGAT	NFKB1
GACTATATANNN	EGR1
CCGATCTCGAAG	NR4A1
GATAACTCCNNN	RELB
GTCGAGCGATGN	EGR4
GCTCCGAGTTNN	JUN
ATCTGTCTCTTN	DOK2
GGGTCCGGCGGA	EGR4
GCGGCATAAACN	LAT
ATTGCGCGTACN	PTPN11
GTATAGGCCCNN	CTRL
CGGTGGCGAAAN	JUND
CTGCGCCGTGTN	DOK2
GTCTCGCCATTN	NFATC1
CCATGTGCCCAN	CTRL
CTTGCAGTGTNN	NFATC2
CTCGAGCCGTGN	CTRL
TTTTCACCAGNN	CTRL
TTGCCCTTTACN	JUND
ATTATCTCCNNN	FOS
GTATAGGCGCCN	CTRL
TTATTACCACAT	NFATC3
GGACGTATCAAN	JUNB
TTTGACCTCGTG	NFATC1
TTCTCTGTTAAG	NFATC2
GCAACCTTAGAG	EGR4
AGAGCATGCCAN	NFATC3
TTGACCTCGTGN	NFATC1
CAGCGTTTCANN	NFATC2
ACAGGGCACCCN	EGR1
AGTCGAGCGATG	EGR4
AGATGATGGANN	CTRL
CTTCGCATGTNN	NFATC2
CAGCATCGGTNN	CTRL
TGACATGTTGNN	JUND
AGAGGACGAGNN	DOK2
CCCCATACCGNN	EGR3
TTAGCATTATCN	JUNB
ACCTAAATCTNN	NFATC1
CTTCAAACTCAN	JUN
CGGATGCACTTN	GATA3
CTCGAGCCTGNN	CTRL
TCCGATTGCTNN	CTRL
AAGCAAGAAGNN	NFKB2
TACACGATTGNN	EGR2
GGCGCATCAANN	EGR3
ATATTTACTATA	REL
CATGTTCGGGNN	NFKB2
GCCGTCGCGAAA	EGR1
ATCGCCTGTGAC	CTRL
CAGCTGCGCCCN	NFATC3
ACCTAAATGCTN	NFATC1
CTGAACACCCNN	CTRL
AACAGGTGAAGN	CTRL
GTCAAAGTCGNN	EGR3
CGATGGTTTTGN	JUN
ACCTAATCTNNN	PTPN6
GTACGTCTGAAN	PTPN11
TTGTGCTTCTGN	EGR3
GGATCGTGAAAN	DOK2
ATTGCCTAACNN	CTRL
GATCTCGCCATT	NFATC1
GTCATTTTTNNN	JUN
GTCCTCTGCCNN	NFKB1
CGATGTGTTTGN	JUN
CGATAGGTCANN	CTRL
AGAGTCTCCTNN	PTPN11
AAATGTGGANNN	CTRL
GATCTCGCCTTN	NFATC1
TAAGATACTTAN	NFATC1
ACCTCGTACTGG	FOS
CCAATGCGAACN	RELB
CCAATGCGACNN	RELB
ATCTGTAATATN	ZAP70
ATCTGTAATGAT	ZAP70
CAATATCTGCAA	NFATC1
CCTCGTTTTATC	JUN
GTAATGTGTATN	RELA
TTGTTTGATTNN	NR4A1
TCCTTTACCGAN	CTRL
TCCTTTACCANN	CTRL
CGTATTTCCCNN	NFATC2
TTACACATAAAT	REL
CTCAGCCCATTG	RELB
GGAGGTTCGNNN	PTPN6
CCACGCTGATTN	RELB
TATCTGTGGGNN	EGR3
CGGGTGGCGAAN	CTRL
CGGGTGGCGAAA	JUND
TCTACAGCGCNN	CTRL
TTTTGAATTGGC	CTRL
CTGTTTATTTCA	RUNX2
GAGCGCATCAAN	EGR3
TACTCTGCGNNN	FOS
TACTCTGCGCNN	FOS
CCGCCAGCCTCN	FOS
CGGACGTAACNN	NFATC2
TTTTTCGCATNN	JUNB
CGCGTCACACCN	CTRL
CGAATCGTCTTT	NFATC1
CCTTTCAGCANN	BACH2
CACCAACCTNNN	PTPN6
TTCACTTTCAGA	CTRL
TCGTAGGCTTNN	BACH2
GGTCATTATTTN	JUN
TTAGACCTTCCT	LAT
CCATGACCATCN	JUN
TTTTGTTTTTNN	REL
TTTTGTTTTTTN	REL
AGGCATGCCANN	NFATC3
GGGTTCGCAACT	NFATC1
GGGCGATGATCT	BACH2
GAGGGTTATGTT	NFAT5
AGGCGCCGATTC	EGR3
GATGCTGACTCC	BACH2
ACTAAGTACCTT	BACH2
CATGAGTTCTAT	CTRL
GAACTGCGGCCT	BACH2
GCCGCTCTAGAT	CTRL
GACTAACGATAC	NFATC2
CTCCTTGTCCAC	DOK2
GGTATGGCCTTC	CTRL
TAGGATCTCTCC	NFATC1
GCGCAATTGTTA	NFAT5
TTAAAGAACTCC	RUNX2
TACAACTTTCCA	NFKB2
TGAGAATGTGTG	JUNB
CACACGCATTCT	CTRL
ACAAAGCGGGCA	NR4A1
TGTCGATGCATG	CTRL
TGGGAAGGATTA	FOS
GCTGGGGCTTCA	RELA
TACCTGTCCACA	EGR4
CGTATGAACTCC	EGR2
TTAGTTTTTTTT	CTRL
ATGCCTGAAGAG	EGR3
TGTGCTCTTCGA	CTRL
ATGGCACGGTCC	CTRL
CGCTAACAACAC	CTRL
TCGTATAGAAGC	CTRL
TCTGTCCGTACG	JUNB
GCTCGCTACTCN	RUNX2
TGCCCGCGGGTA	CTRL
GTGTCAGACCGN	JUND
GATGACGTGAGC	EGR3
CTCAAATTTCCC	EGR3
GTAGGGCCCCTC	GATA3
ATTTATGGTGGC	DHODH
AGTCGCACTACT	EGR2
GAAGCCCGAATT	NFKB1
CGCCTCGGCTTC	NFKB2
GTTTTGCACGGT	CTRL
CCGGCATAGTNN	NR4A1
CGTGAATGGTGA	NFATC3
GTCTTGTCGATA	EGR3
GAAATATCTGAA	CTRL
CCGTGATCTCGG	CTRL
TTGTTTTAGATG	EGR4
GCATTAATTTGC	REL
GACTTATCGCAA	EGR4
AACCATTTTCAG	CTRL
ACACCCTCTTGN	NFATC2
ACACTACAAGGC	NFATC2
ACGCTGATAACT	JUN
AGGCAAATTAGC	NFKB2
TGGGATGAATGA	DOK2
GAATGAATCCCT	BACH2
CCCGCTCGCCGT	ZAP70
TCTCCGAGCTAA	RELB
CCCCCTTCTCCA	BACH2
CGTTCCGCGCGG	CTRL
CCCAATACAGTA	FOS
TTACCTTCAGGG	NFATC1
TGGTTGCGAAGG	RELA
GCCAACTGAAAN	FOS
TTATATGAGGGG	FOS
GTTATGTTTTTC	CTRL
GCGGTTAAATTC	BACH2
GGCTTTTTCTAC	MVD
GTGGGTCGCCAC	DOK2
ATCACCCTGTGC	CTRL
TTTCCGCGTTGT	NFATC1
ATAGATTCATTG	PTPN11
GCGTATACCGGA	NFAT5
GCGTATACCGAN	NFAT5
CGCAAATGAAAC	NR4A1
AGCACATGCTAG	RUNX2
GTGTGAGCGGCC	RUNX2
GCGGGAGATTAT	PTPN6
CCCAATGAAGGG	FOS
TGGTAATTGGCT	EGR1
CACTGTGTGCGC	CTRL
CCGGATAGTCGC	BACH2
CCCCATTATGAG	DOK2
ACGGTTGTCAAG	MVD
CCCGGCCCACAC	CTRL
TAGTCAGGGGGG	NFAT5
ACATAGTCTCGN	PTPN6
GTGCATGCATCA	NFKB1
ATGTGGAACTGN	CTRL
GGGCGCTTCACA	CTRL
CGTGGTTCCGGT	NFKB1
CAAGAACTCAAC	JUN
ATTTGCAAATTG	EGR3
TATTACTCTCTG	CTRL
TGAAAGTGGCTT	CTRL
AAGCAGTACTTA	NFKB1
CATAATCCCTCC	NFAT5
CGGCCGATACGN	EGR2
ACGCAATGTGGG	RUNX1
TCCCATCAAGGT	EGR3
GAATGCGCTTTA	NFATC2
AGACTCATCATC	JUND
AAGCAGATCTCG	BACH2
CTTATCGCTCCA	EGR2
GAGACTTTCTGC	PTPN6
TGGCCACCACGC	JUND
CCACTAGTCCAT	EGR4
TTTCCGCCGTCT	EGR4
TTCGAGGCCGGG	JUNB
GTTTTAAGAGAT	PTPN6
CTAGAACTTCAC	CTRL
AGAGTCACAAGG	PTPN11
GCTGCGATCCTC	FOS
AATCTTATCGTA	EGR4
GGCAGACTAGGG	REL
ACAACTGGCTTC	CTRL
GATATCCTAAAC	NFATC2
ACTGAAGACTTG	REL
TGCGCGTATTTN	RELA
TGAATTAGTCCT	TUBB
GGCATGCGGGCC	REL
GATAGGGTGATN	NFAT5
CCACTCAGTGGA	RUNX2
CGCGGTTCGTTA	CTRL
GCCCGGGCATAG	BACH2
CTATAAGATCTA	RELB
GGCAAAAGTAAT	FOS
AAAGTCTTCGTT	FOS
CCGTTGAACTAC	CTRL
GAGCTTGACCGG	NFKB1
ATTATTGAAGGT	RELB
CAGCACACTCCN	EGR3
CCGAAGATAATA	CTRL
GCTCTGCACGAA	CTRL
TTCTGGGGTAGA	MVD
CCGTCGAGATTA	PTPN6
CATGCTCAGGNN	EGR3
ATGCGGTAGTCC	JUN
AGTCCTGATGAT	CTRL
CTAGAAGAGGGC	CTRL
GCAATGAATCCC	EGR1
ATTTGTTTCGTA	PTPN11
CCACAGACAGTN	CTRL
CTGTGCTTGCGA	CTRL
CGCCGAAGCATC	CTRL
CGCCGTACGGAT	DOK2
CCTATCATTAAG	RUNX2
TATTGCCAGGCT	RELB
CCGTCCTAGGAC	EGR2
TCGGATAGACGC	CTRL
CGGGACTTACTG	JUNB
GCGAAACACTGC	REL
CCGGCCCCGCTT	MVD
GGTTAATGTGCG	NFKB1
ATACGCCGGTGC	NFKB2
ACACTACCTACA	PTPN11
TGGACTTTGAAN	NFKB2
TAAAAAGTAATC	NFATC1
GTCCTGGACAAT	CTRL
GACTTTGGTCTC	JUND
CTGATGCCCTTT	FOS
ATCAAGCGTCTA	CTRL
TCCATTGAGCGC	NFATC1
ATAATTGGATAC	CTRL
TAATCGCAGTTC	BACH2
GTGTATGTTACA	NFKB1
GCTCATCATTTC	PTPN6
CATATTATTCCC	CTRL
AAGTGGCGCCGN	NFATC2
ATTGCATAGTTT	RELB
GTCGTAGTTGGA	RELB
GGAGCCGTATAA	CTRL
CCCGACGTTGCT	NFKB2
ATGTGACACATA	REL
CTGCTGGACTCG	BACH2
TTCTGTTCGACA	EGR3
CGGTGAACTGTA	CTRL
TGTAATAAGCCA	RELA
CAGGATATCGAT	DOK2
TAGTCGTATTTT	JUN
AATCGGTCTCTC	FOS
CGTGTACTAGGG	PTPN11
GAGAGCTGGATC	EGR4
TGATTTCAGTTA	RELB
TGCGGAGCATGC	JUND
GCTGAATTATGA	ETS1
ATCACCCTTTGN	REL
CGAACTAACGGA	CTRL
GCTCCCGCCTAN	NFATC1
TCACGTGCCCGG	CTRL
GGGCGCCGATTC	EGR3
ACCCTCGGACCC	FOS
GCTAAGTACCTT	BACH2
ATAACCGTTTTC	NFKB2
CATACCGGGGAA	NFKB1
TGTCCTGGTAAT	NFATC2
GTACGCTTGCAG	NFAT5
GTGCAAAGCTTT	CTRL
GCGCGCGTTTAA	JUND
CAGTCGGCTGAG	CTRL
AGAACAGCGGGA	NFKB1
CCCAGCCGTTNN	CTRL
TAAGTAGCCCAT	JUNB
AAGAAGGCGACA	NFKB2
GCAGCACACTCC	EGR3
GGGTACGCGCCA	EGR1
GGCAGCATGCGT	NFATC3
TCCCAGGCTCCA	NFKB2
GTACTAGCAGAG	ZAP70
ATGTTCCATTTT	NFKB2
CCAGCTTTGTGN	NFKB1
TTTGATATGCCA	JUNB
CTTCAGGAATTT	JUND
GCAGCCCGAATC	RELA
AGTGGCGAACGT	NFATC2
TTCCAGTCTTAC	ZAP70
GCATATAGTCAA	NR4A1
CTTTCTCGAGAC	RELB
CTGCAAACCGGG	NFATC1
TGCACAGCCTCA	MVD
TCGGGACCGGTG	NFKB2
GTGCACTCGAGC	NFATC1
CGCTCCCCCACC	PTPN11
TACTTTGCATTC	PTPN6
ATAGAGAAGATC	CTRL
TCGCATTCGTCA	CTRL
CAGACGTTCTTG	CTRL
TCCACGTGTCAC	RUNX1
AACTAACTAACN	RUNX2
GAGATCAGGAAN	CTRL
TTCCCACTAATG	FOS
CTAGATTAGTCA	PTPN6
CAAAACATCGTG	NFATC3
CGACGAATCAAC	CTRL
GTCGAATAACGT	RUNX2
TATCCGCCGGAT	NR4A1
TACATGCGATGT	JUND
AGTGCTGGTGAN	CTRL
GTCGAACAGAAG	RUNX2
ATGGCAATGTAC	EGR2
TAAGCGTAACGC	PTPN11
GATAGCATCTAG	EGR3
GCGTATCGTTCG	CTRL
AGCGGTCTCCGA	CTRL
AGAGGTGTACTT	CTRL
GCCGTAGATTAT	NR4A1
GATAGCATCATT	JUND
TGGCGCAGTAGG	DOK2
CCGCGGAAGTGA	EGR1
GAATTATCAGCC	JUN
GGTTCTAGGCCT	CTRL
GCTTACAGCTCC	RUNX1
TCAGGTATCCAT	CTRL
AGGTCAGTTCGT	LAT
TCTTGCTCCTAG	ZAP70
TCGCCCAGCAGT	ZAP70
CACTGACAGGTG	RELA
ATTCTCCCAANN	CTRL
TCGTCTAAACCC	CTRL
AGTTCGCATCAC	ZAP70
ACACAATAAGCA	LAT
GATATCCTTTGC	BACH2
CGTACCACAATC	LCK
CAAATGACGACA	NFAT5
TCCTAGTTCCGA	RELA
AACCATATAGCC	DOK2
CGGTAGATCCGT	FOS
GATCGTGGTGCA	EGR3
GCAAGCAGGATA	NR4A1
AATTTGTTGACC	BACH2
ACACAACAGCCT	EGR4
GCCCCACAGGGA	EGR3
AGCTTGGAGCGG	CTRL
GGCGGGCGCCGN	FOS
GTCTTCGGCGAC	RUNX2
CCCATTGGCTGA	CTRL
TTACTTTGACCA	NFATC2
CCCAGTTGCTAT	NR4A1
CGACACCACCAC	NFKB2
AGCCCTATGGGA	PTPN11
TTCAAGACGAGG	PTPN6
CGTTTAGCTCCC	NFATC3
GCCCTTTGGCAT	JUNB
CACTGGCCGGAC	LAT
GTTCGCCAGTAT	REL
AATCAGCTTAGT	JUND
ATCCACGACCCA	CTRL
CCTCCAGGGGCC	EGR4
GGTGAAATCATT	JUNB
TTTCTGGAGAGA	PTPN11
CCATCTCCCCGT	CTRL
AAGGAGCGTTAA	CTRL
AAAACCGGAGAT	DOK2
TAACACGCGGAN	CTRL
CCCTGCGCACGC	BACH2
ATTAGATAACCC	CTRL
TAAGCTAGTAAA	EGR2
TACAGACTCTCC	NFATC1
CGCATTCGGGAC	CTRL
CTAGGATGCTCT	CTRL
CATCAAAACAAC	CTRL
TACTACGAAACT	JUNB
TGAGGCCGTAAC	FOS
AAGTTTCCCTGC	CTRL
CGCCCTTACCGG	ZAP70
TTTCGCTCCATN	NFKB2
AGTAGTTATAAA	NFKB1
CTTGGCAAGATA	NFATC2
GCCTACGGTAAT	CTRL
GCAGTGAGGGTC	JUNB
TAGCGACAAGTC	REL
GCGGTGACGACT	NFATC1
AATAACAACTGT	JUN
TTGCGGCACGCA	NFAT5
CTCGCAAGATGG	EGR4
CTGAGCTTATTT	CTRL
ATGAGCACAAGC	REL
TTCCAAGAATCA	NFATC1
ACAGTTTCTAGG	CTRL
GTCGCGGTATGT	JUN
TAGGATCCGAAT	CTRL
CAAGTCTTTTTN	CTRL
TTTTATTTGTAC	NR4A1
ACGGCGGAAGCA	BACH2
TCGGTGTTGTTT	ZAP70
CGGTATGAGGAT	RELB
GGTCCGCTGTAC	BACH2
GTTGTCCCTCTA	FOS
AGCTTAGTATCA	NFKB1
CGGATGATGTTT	EGR2
TATAATGTAAAT	CTRL
TATTTCGTAATC	NFATC3
GCAATTAAGCTC	EGR1
GTCTATTGCGGG	GATA3
TTTCTCGCCTCC	FOS
TCATGGGTATGA	CTRL
ACGGGAACGGCC	NFKB2
TTAAACTACGTC	PTPN11
CAGAGTAATCGT	RUNX2
TTGCTCCTATCG	LAT
TGCCTTCCTCAT	NFKB1
TACGAGGAGACT	EGR2
GTTCCTGTCGTC	RELB
TCTTAGACAATC	PTPN11
ACTACGCTTCTC	RELB
AGGCCGACCAAC	ZAP70
TCTAATGAGAAA	NFATC2
CTCCTAAGAGGA	JUNB
AGGCGTTCACGA	NFAT5
TCTTCCAGACCC	BACH2
GAACTATTGGGA	EGR4
CGATTCATCCAA	NFKB1
CCCGCGCGGTGT	NFKB1
CTGTAGTATGTT	CTRL
ACGCCTGAGGCC	REL
CGTCGGTTGGGA	NFKB1
ACAGTAGTAGAC	PTPN11
ACCACCTTATTT	DOK2
TACGAACGTAAC	DOK2
TACCACGTGGAA	RUNX2
CTGCGGTTCTTA	NFATC1
AAATCGCCCCCT	CTRL
ACGCCCGTCGCA	PTPN11
ACGATTTATATA	CTRL
TAAGTCTTATTC	REL
AGAGGGAACACA	CTRL
GCGGGTTTTAGC	DOK2
AGCCCATGTTAG	DOK2
TGTTAAGTTCAC	NR4A1
CAATCACACAAA	CTRL
TTCCAGTTGGCG	EGR2
ACCCATGTATCG	NFATC1
TACGTTGGTGCC	CTRL
ATTGCCCCTCAC	RUNX2
CGCCGTATATCA	RELB
TATGCTATGGTG	BACH2
AGTTATGTCACT	RUNX2
TAGGCCGGCGCG	PTPN11
TGGACACTTAAT	NFATC1
TACATAATAAGT	PTPN11
AGCAATACGCGT	ZAP70
TACAGCATGTAT	RUNX1
TCGCTTACCCAA	NFATC1
CTTAGTAGGGAG	EGR4
CTGACCGAGAAT	LAT
AAGAGCCTGACG	DOK2
CCGTTTGACCTG	NFATC1
CGATCACCTAGA	CTRL
TTCGTATTAAAG	FOS
AAGGTCCCTGTT	NFATC2
TACGTGATAAAG	DOK2
CCTCGTACGGGT	DOK2
TTTCGCTACAAC	CTRL
TTGTGAAATGCG	CTRL
CCGGCGAGTCAC	NR4A1
CGGACTTATGGN	CTRL
TGGAGGATTTCT	NFATC1
AGCTTAGTGGCC	NFAT5
GTTTAAGCCTTG	RELA
ATGAACCGTGCC	RELA
GTCAGTGTTGTT	EGR3
CCAAGCACTCCG	CTRL
ACCGCTCTAGAT	CTRL
TTACGATACCAT	CTRL
CTAATGCAGGCT	EGR1
GGGCAGTTATTG	JUN
GGCATCGTCCGT	RUNX2
GGGGACGAGCGG	CTRL
CTTCTGTCTTGT	JUN
GAAGTTGGGGAA	NFATC2
TGTTGCCGATCT	EGR3
GCTGCCTATCTC	CTRL
CTTTATTAAGAC	JUNB
GTCATGAGATTT	JUN
GGGCGGCATTCA	EGR1
TGTGCCCTTTGA	ZAP70
AGAGCCTTTCCA	NFAT5
AATTATAATAGC	JUN
GCTCCGATGCGG	EGR2
AGGCAATCAGCA	NFATC1
TACGTTACCATG	DOK2
TCGTCCCATACT	NFKB1
GTATGTGGAGCC	JUN
ATATTAAAGCAC	CTRL
CCTACTTACTAG	LAT
GACCTCGACAGA	CTRL
CGTAACCGTAAT	RELA
CTTATGGCCGTC	DOK2
GGCTACTAAGAG	JUN
GAGACCAGAAGT	REL
GCAAGCCGCAAN	JUND
TGGCCTTGACTT	FOS
GTAGTTGCGTGA	NR4A1
CGATGAATCGGT	NFATC2
CGGCCGCGAAGT	JUND
GAGTCGGTACTA	FOS
TATCGGTAGACC	EGR2
TTATGGGACAGC	EGR1
TACTGCGAATTC	CTRL
GCCGCGCGAGCA	EGR1
CTATACCAAGAA	RELB
TGTATAGTTTAA	CTRL
CGAAAGGCTCAC	RELB
CGAAAGAAGGAC	JUN
TTAACGAGGCGT	BACH2
GTGAACCGCGTA	BACH2
CAAATCAACATG	CTRL
TAAAAACTGAAT	REL
GGGATTGAACGA	CTRL
AACGGGATGGTG	CTRL
CGAAGTGTGAAG	NFKB1
GGTCCGGACTCG	CTRL
AGTTAGCGCGAA	NFKB1
GCGCCGATATTT	JUN
GAATGTATCCTT	BACH2
AGACGAACAGGG	EGR2
GGCTACTAGAGN	JUN
ACCGTGAGCGCT	LAT
TGAGCTTGTTAT	CTRL
AGCCACTGGTAC	REL
CATATCTAGACA	ETS1
TCGATCAGAAGC	EGR1
TCTAAGCTCGAA	RUNX2
TAAGAAGACCAT	FOS
GCGTTAGTTTCN	CTRL
CTCCTATTGTAC	RUNX2
CACATTCCATGC	NFKB2
GCCGGAGCTCGG	CTRL
ATGGCGTATACG	EGR4
ACTAGTTAGCCG	PTPN11
ACAAGCCAGAGT	NFATC1
AAGTGAAGCTCC	NFATC1
AGCGCGCTGGCA	CTRL
TTATGTTAGTTC	CTRL
AAGACGTCCGCC	RUNX2
TAGAGTTGGGAC	NFAT5
TTGCGCGTGCTT	FOS
CACTACCATATT	EGR1
AACCCGCCAGTC	RUNX2
TGAGTCTGATTT	EGR1
ACGAGTCAAAAC	CTRL
TTGCCGTTAGAA	CTRL
TAACGCCTTAAN	JUND
GGGAATGGGACG	JUNB
ATTTACGCGACC	DOK2
GATTATCGGGAC	LAT
ACATTCTCCCAA	CTRL
CGATTGGGTATC	BACH2
CTGGGTGCGTAT	NFATC3
ACCAACTGAAAN	FOS
TTGCTACCGAAN	NFATC2
TACCCTCCAGCA	CTRL
TACGTCTGTACT	EGR2
TAAGCGAGGGGT	NFATC3
GATAAAATCACC	DOK2
TCTCCCCGTAGA	CTRL
ACGCATTCCTCG	RUNX2
GCCGACGAAAGT	CTRL
CTGAATCGAGCC	NFATC2
ATGGCCCCTTCG	JUNB
TCAAGGACTTGA	PTPN6
CAGGCCACTTGA	JUND
AGACTGGTCCCT	NFKB2
ATCGTTCTCTGG	RELB
CCCAACCTTTAC	CTRL
GCTGCACGTATT	MVD
AGCAGGATGACT	EGR2
AACGAGCTGGAC	CTRL
ATTCATGAGATG	REL
CCTACGAAGTGA	PTPN11
GTCACCCCATCC	EGR1
TACACGAACGNN	PTPN11
GGGTAATTACTC	EGR1
TGACTAAACCTG	NFATC3
CAATGAATCCCT	BACH2
CCGACCAGGGAT	JUNB
TAGCACATGCGA	NFAT5
TGTTGCACTGTA	RUNX2
CCTAAATCGCTA	CTRL
AAAGGTGGCTAA	CTRL
GACGTTCGTTAA	NR4A1
GATAATAGGTCA	PTPN11
TCTCGGTGTTCG	EGR4
CATTCCGTTGCN	NFKB1
GCCCGCCCGACT	EGR2
GTAGCCGACTGT	JUNB
CACTATGTCTCA	DOK2
CCTCAGAGTAGA	PTPN11
GGGTTTGTGATC	PTPN11
GAGGAGGTACTC	REL
CGTGTTTCTCCN	CTRL
ATCTCATCAGGT	PTPN6
TGGTGCCGCTGT	NFKB1
AAACTCACGTTG	CTRL
TGGTAGTACTAA	EGR2
TACGTTTGCTTT	LAT
CAGTTGCGCTCT	RELA
GTTGCATTCAGC	RELB
GATTGTGAAAGG	CTRL
AAGAATAGTCGG	RELA
TGGAATGTTACG	CTRL
TTAGCCGCCAAC	FOS
CCTTGGGTGGAN	FOS
AGAATCTACACT	DOK2
CCATTTACGCCC	PTPN6
GTGAATGGTGAN	NFATC3
GTTGGGCCTAAT	CTRL
TGCAAGCCGCAA	JUND
TGTTTTTAACGG	JUND
GCTAGAGACTAC	LAT
AGATGTCTTATA	RUNX2
GCTGCCGCGCAG	ZAP70
TTCACGTGTAGT	EGR2
CCTCTAATCATT	CTRL
ATTAGATTCCAT	CTRL
GCTTGCCGACCA	RUNX2
GCCACCTTATTT	DOK2
GTCGGTCGCTTC	NFAT5
GGGCTATAGGCC	PTPN6
CGCTGGTTGGAA	PTPN6
AGCCGAATGCAT	EGR3
GTACAAAACAAC	MVD
CCGGTTTTTTGA	ETS1
GTTCATAGGGTA	NFATC1
TATGCCCGGCTC	RUNX2
CCAGTGGTCGAC	DOK2
CGGGCGCATAGG	LCK
CAACCGGCACCA	JUNB
TATCTCCGATTA	CTRL
GATTCCTACGCC	EGR4
TCGCCATCTTGT	RUNX2
GCAGTGTGGTTA	EGR4
CGCGAAGAGTAG	NFAT5
CTGTGTCCACTA	CTRL
TTAAGAAGTTTT	CTRL
GATCGGGGTGAT	NR4A1
CTGACTAAAGCC	JUNB
TTTCTCCCCGCA	JUN
GCGCTTTACAGT	NFATC1
TGCGTACGCTTG	EGR1
CTTTTGATGCAT	NFATC3
AGTCAAAGCCGA	RUNX1
GTCATCAGCAGG	REL
GTTAGGGTGAAC	BACH2
AAGTGGTATCAG	REL
AGCTAGGATTAA	NFATC3
AAATATTGGTGT	EGR3
CTTGAGGACTGC	NFAT5
CGTGTCGACTCT	CTRL
ACAATGAATCCC	EGR1
AAGTTGGATAAG	DOK2
ATTTTTTTTCAA	EGR1
GGCGGAATTACG	EGR4
ATCCGCCCCACN	FOS
AATTATGGAAAG	EGR2
ACTGTATGCAGC	NFKB2
CGTCTAGAAGTC	LCK
CCAGAATCAAGT	PTPN6
GTGGACCAGTAC	NFKB1
ATCATCTTTGTG	TUBB
GGTAGACCTTTT	NR4A1
GACTCTCCAGAC	EGR2
CCAGGTCACGTC	CTRL
GGAATGTACCAT	JUN
AAGAGCAAGGGC	DOK2
GACCCACCCTAN	JUND
CAGAGTCTATAA	LAT
GAATTAGGTGAT	NFATC3
GTGCTGATGTTA	NFATC1
GATTTTTCTCGC	NFATC1
CGTGAATGCGGA	CTRL
CTTGATCCTTTG	CTRL
CCTTTGCGCTCG	EGR4
ACTGAACTGCGC	CTRL
TACCTTTTAAGN	JUN
TAAAATGTCTAA	RUNX2
TGTTAGAGGATG	RELA
GGAAAGACTCAG	CTRL
CGAGATGAGATA	PTPN11
CCGCATTAAATC	NFATC2
AGACTTGACTGC	JUNB
CTGAAGCTATCC	JUN
AACTTCCCCAAA	DHODH
ATTCCGGGCTGT	EGR4
TCCAAGGAGCAG	NFATC1
GGCTTCTGAGGT	NFATC1
CACTCTATCATC	CTRL
GGTATCATTGGT	CTRL
CAGGGGTACATA	CTRL
GTTTGAGACAGG	CTRL
ACTACCACTCAG	PTPN11
CGTTAATGTTGT	JUNB
AGTGAGTTTTGG	JUNB
GTTATTTACACC	NFATC1
TAGTAGATGTCA	LAT
CCGGGATCCACT	EGR2
GGGGCTCGAGGT	PTPN11
GAAGAAGTGTTN	CTRL
GTGATAGACTTT	NR4A1
ATTGGGACCAGG	JUN
GTCGCAGACAAC	PTPN6
AGATGCTACCGT	EGR1
TGAGATAGAAAA	CTRL
ATGCTTCAACTC	EGR4
ATCATGCAAGCC	CTRL
GCCGCGGTATTN	CTRL
CCCTGTGAGGTA	DOK2
ACGAACAAGACC	JUND
AACACTCCACGT	PTPN6
TAAAGGCTACTG	CTRL
GTCGAACGGGCG	CTRL
CCGTATCGGATC	NFAT5
CCACACTAGGCG	NFATC2
TCTTATGGTGAG	DHODH
GACACGCAGATC	JUN
GCCCTAGTGCGT	BACH2
TTTCTTAAAAAG	GATA3
TGGCGGTTAGTC	JUN
TTGCCCGCAGAC	EGR4
CGCTTTCGCGGG	NFATC1
AAACCCGCCCTC	CTRL
TGCATCGGAATN	RUNX2
TTAGTTGCTTTT	CTRL
TATCCGCGCCCT	FOS
TTTTAGACCCTT	CTRL
ATCCCTACTAGN	NFATC2
TAGATGATGTTT	CTRL
GCGCGGGTTCGT	EGR4
GTTCGCACGTAA	PTPN11
CTCTAGTCCCCC	EGR1
GAGACCCGGGTN	NR4A1
AGTTAATAGCTG	CTRL
GTAATTGCTCCT	CTRL
CAATTTATGATC	DOK2
CCATCGGTCACT	CTRL
ACCGACTAGCTT	CTRL
CGCACTCGTCGT	EGR2
GCCCCTGTCTCT	CTRL
GTCTAGAAGTCN	LCK
CGGACCTAACAC	DHODH
ACGGATGAGAGT	RELA
TCGCTTATCCCT	PTPN6
GACTCTTGTTGC	NFKB2
GTTGTCCGCTTC	RELA
CGTATAGTCATA	JUN
AGTTAATAGTGN	CTRL
GTAACGCCGAGG	NFAT5
GCCACTATTTTC	CTRL
GATGACTAGCAN	PTPN6
TACACTCTGTGA	CTRL
GAACGCTACCGN	JUN
GCGCAGGCACCT	PTPN6
ACCGAGAGGACC	NFKB1
CTTAGTCCAGCA	NFAT5
CGTTTCTCCGAN	NFKB1
CGCTAGTCACTG	LAT
GAAGCATACTTC	EGR2
CCTCTATATAGT	NR4A1
TTCTCAGCTAGC	PTPN6
CTATCCATTAAC	LCK
CTGTCCACATGA	EGR2
CCAAGCAGAAAG	CTRL
TCGGTAGGATTA	ZAP70
ACCGTTTCTAAN	CTRL
GCTTGCGATAGG	NFATC2
GTCCACCCGATG	JUND
TAGCCCGGGCCT	JUN
GTCATTGGATAC	CTRL
TCGTACAAGANN	NFKB2
AGGAGTTGCAAN	EGR1
ACAACACCGTAC	CTRL
CAGACACTATAC	CTRL
TGTATCGGCCCN	CTRL
TTGGACTAAACT	NFATC1
TGCTAATGCAGG	CTRL
CGATTAGTCTGN	EGR2
CACGCGACACTN	CTRL
GAGAAAGTTGGG	LCK
ATCGCTGGGATC	NFKB1
ACCTATATGGAA	CTRL
TAGTGGTACATN	CTRL
CATACTCCACTC	CTRL
AGCTACGATACA	CTRL
CTGGTTTTCCCA	NFKB1
CAGTTCAAGCGC	CTRL
GTAACCTGGTGA	NFKB2
TGTATAGAGACG	JUN
TCGTACAAGTGC	FOS
GCCTCTGCTGTA	NR4A1
TCGATGAATGTT	CTRL
AGCCTCGGTTTT	ZAP70
CAATATCGTTAA	NFKB1
TGTTTCGAGGTC	CTRL
TGAAACGACAAT	CTRL
GAGCATGGGTAG	NFATC3
CCCTCTCAACGA	CTRL
CGAGGTGACTTA	CTRL
CGCTAGGTCTAT	CTRL
TGCTCTCACCCT	JUNB
CTGTGACCACCT	JUNB
TCGGATATTCTA	RELA
TGTCTACTGTCT	NFKB1
ATAGTGCGTCTG	NFATC1
CACATCAGTGAT	PTPN6
TTTGTCAGTATT	REL
GGAGCCCGTGCA	REL
TAAACCCTGTAA	JUN
CTTGCATCCTGA	ZAP70
CCTACTAGTACC	NFKB1
ACGCAATCGCCA	CTRL
CTTGTGTCTGAC	NFKB1
TGCTACTTAGTC	EGR3
ATCAGCAGGTCA	BACH2
CGGCCTGACATT	CTRL
TCATACCTTTCG	RUNX2
AGAATAACTTTC	RUNX2
GTAGTTCAGTAT	GATA3
AGGTATAGGTCT	FOS
AGCCGATTATTG	EGR4
TTGTGAGCCTAG	CTRL
CGCGCGGCTTCC	CTRL
CAATTAGTATTA	CTRL
CCGGCTCGATCA	NFATC3
TTTAAGAGCGGC	PTPN11
TTGATTTGTCTT	EGR3
CGAACAAGCTCC	NR4A1
TCACTACGCTGN	CTRL
CGACACGCTTTT	REL
CATACACTTCCA	JUND
TTCGATCACGCA	DOK2
ACGAAGTCTTCC	NFATC1
CTTCTTGGCTAC	NFATC3
ACGTATTCGTAT	NFKB1
GGCTTTCTTTCT	CTRL
GTAAATCTTTCA	NR4A1
CTGGGCATTGGT	CTRL
GCCTGTTGAAGA	CTRL
TGAGGTAGAAGC	JUNB
GTGCGTCTCGTT	NFKB2
TTACGTGTATCC	JUN
ACAGAAGGGGCC	JUND
GTACCCCGACGA	DOK2
AAATCGAGTTAC	LAT
CGCTTGCTCTTA	NFKB2
ATAATCGAATAT	CTRL
ATAGCGGAATCC	CTRL
AACCTCTTGGGG	CTRL
CCACCTTCGGCA	FOS
TAGAAGATACGC	JUN
GTGATCGCCTCC	JUND
AGGGAATCCTCT	NFKB1
GATGCACGCTGA	CTRL
ATCCGTCCCCAC	FOS
TCTATAAGGCAT	CTRL
TAGGTGTTGTCC	NFATC3
ACTCTCTCTGGC	EGR1
GACTTGCAGGCG	PTPN6
ACTAATGATCCC	CTRL
CAACACTGAGTN	CTRL
TACGTGTGAAGG	PTPN6
CTGCGGTAGATG	CTRL
AATAGTTCCCAT	CTRL
AGGCTCGCAGGT	CTRL
AAGCAATTCCTA	CTRL
CGCTGTCTCGTC	EGR4
CTCACACCGGAT	CTRL
CCAGGCACGGAG	CTRL
GAGACCTCCAGT	CTRL
CTGGTAAGAATC	CTRL
CTGTCCGCTTTA	ZAP70
CTGAAGGAGGNN	JUN
AATCAAGACGGG	RUNX1
TGTAGTCGACCG	BACH2
CCGTTACACGCA	NFAT5
TCAGACTTGTGT	EGR2
TATCCCCGCTTC	FOS
GTAACTGACTTA	CTRL
GTGTCTGTTGTA	CTRL
TCCCAACGTAAN	PTPN11
CGCATCCCAAAT	DOK2
GCGACTCTCTCC	CTRL
TGAAACAAGTCN	JUNB
GGAAACTCCCTG	CTRL
CTACTTTGTAGC	PTPN11
TCGGCTCTCCTG	CTRL
CCCAATGATCAT	FOS
TTTGCGACCTGA	DOK2
GAGTCTGTGGAT	EGR4
GCTGCTTGCAAT	NFKB1
CCGAATGAGCTG	NFKB2
CGATGTGTCGAT	DHODH
TACTATATGCGN	CTRL
TTGACGCATCTT	CTRL
TAGAGTCTCAAT	CTRL
GTCCCGTATACT	REL
GTCATGGTATCT	CTRL
CGTCGACTGCAG	ETS1
ACACTTGCGTTA	CTRL
GAGTGGCTGCGA	RUNX1
GAATGTAAAGAA	EGR2
GTTGCTGTTGTC	CTRL
GACCTTGTACCG	CTRL
GGCTAGAATCAC	CTRL
GGTAGTGATCCA	JUND
CCCATGCGGTTA	CTRL
CCATCTAAGGGA	EGR1
GGGAATCCCCCT	CTRL
GGGGCCAGACCC	CTRL
CCAGGTAGGTCA	CTRL
ACTCATAAAAGA	JUNB
TAGGCTAACATG	DOK2
ATCTATGATCTC	BACH2
CACCGTAAAATN	JUN
CCTAGACTAGCA	CTRL
CGTCCGCTGTTC	PTPN11
GCTATGGGTCGT	LCK
ACGCCACCTTGA	EGR1
ATCAGATGTTGT	EGR2
GCACCACTTAGC	PTPN6
AAAGCTTCCGGT	NR4A1
CACCGTAAATNN	JUN
TCGGTTTGGTCA	CTRL
ACCGTTCTGCCT	RELB
TTCGCCTTAATT	DHODH
AAATTAGTTTGG	JUND
GGGTTAGGGAGG	EGR4
AGCCCGACCTCC	CTRL
GTTCGTTTTGTG	NR4A1
ACGACCATCGGT	CTRL
GGGAGTCGGACG	CTRL
GCGCACGCGAGG	NFKB2
TAGTTTAGAAGT	NFATC3
GTGACCGGCTTC	PTPN6
ACCCCCGTATAA	BACH2
TGACACACACTT	NFATC1
CTTGTAACAGAG	RUNX2
GAATCAACATTC	NFKB1
GAACCGAAGGCC	CTRL
GAGCCCAAGTCA	RUNX2
CAACTCATGCGA	NR4A1
TGAGGGCACACA	CTRL
TAGCCCGACCTT	RELB
CGAGCCTATATA	JUND
CCCATCGGTTCT	CTRL
CCCCGTAGGTGG	PTPN11
GGCGGGCGACAC	NFATC1
TACAGCTCACTC	CTRL
ATTATGCTCCGG	FOS
GTTGCCCTTTAT	CTRL
TAACAAGATGTC	ZAP70
CCCTCGAAGCAC	NFKB2
GAGTCGGAGTCN	PTPN6
CGTGGATGTCTT	CTRL
TTGCCCACTGAA	NFATC2
AATAACCGAATC	REL
GCTCGTGGAAGC	RUNX2
AATCAAGCTGAT	DOK2
GACAGGAGCGGN	NFKB1
GGTACCAGCTGT	MVD
CCGTCTCAGAAT	REL
GTGTAGAATATG	NFATC1
AGTACACAGACC	PTPN6
GCTGTCGCCCAA	CTRL
TTTGCCGCACGC	GATA3
ATTGAGGTTATC	JUN
CCTCCTGACGAT	NFKB1
GCAAAAGTGAGT	NFKB1
TTACGCGGTCTA	DOK2
CACCCGTTCCTT	NFATC1
CTATAATAGAAG	MVD
ACTACGTTGGAC	JUNB
ACGCGCTTTCGC	LAT
AGCGTTTCCAGC	NFKB1
TCCCTGTAGCCC	CTRL
TCGGCTTTGTCC	PTPN11
CATCAAGAGTTG	EGR4
CGTGCGCAAGGG	EGR4
GCGAACCGTTTA	BACH2
GTCAATGGCCAG	NFAT5
GTGTCAATCTAG	PTPN11
AATCGGTTAATT	EGR4
TCGTAATTGAAT	EGR1
TGCGTAGTTAGC	ETS1
ATATTAGCGTTA	EGR1
AATTACATAATC	CTRL
ATGATATTAGGT	EGR1
CTTTCAGCCAGG	BACH2
TACATTGGAAAT	CTRL
ATCCTCTCAGCT	FOS
AGAGGCAGCCTA	EGR4
GATGAGAAGAAT	CTRL
CACACTTCTCTC	EGR4
CCGTTTGGTATA	CTRL
GGCCGTCGGCAA	LAT
TCAACAGATCAG	EGR1
AGGAATAGAGTC	JUNB
TCTATCTCTCTN	ZAP70
GAAGGTGACTGG	JUNB
TGTGCCTTACCT	BACH2
GTCCTCCGCAGG	BACH2
GGCCGCATACTG	NFATC1
TAGTTCGCTAGC	EGR4
CTGTATCGGCCC	CTRL
AGCCTCCCATGG	CTRL
GAACAGTGTTTT	BACH2
CTACTGAAAGGG	CTRL
TTAATGGAATCC	RUNX1
AATTGTACACGT	NFATC2
TGGCTGCTGGTG	PTPN11
TCATGTCTCGCC	JUNB
TCCGCCATCAGA	RUNX1
GTTACTGTTCTA	NFATC3
TCCTGGCTAAGT	EGR3
TTGATCGACATT	NFATC1
CAGATTGCAACT	DOK2
TAACACGACCCT	BACH2
GCATAAGGTATC	FOS
AATGAGTAGGCC	CTRL
AGCCACGACACG	JUND
TACTGCTTAGAA	LAT
ACAACCGTCGCC	CTRL
CAAGTGTCACTA	CTRL
GGACCCACTCTT	BACH2
TGCATGAATAGC	CTRL
CTATTGAGCGAN	CTRL
AATCGTCCGTAC	EGR3
AGCACTGGTCAG	EGR2
CATTCAAGAGTA	EGR3
TCGGTAAAATAA	FOS
CCGTTGATCCTT	CTRL
GGACGGCGTGAT	LAT
ACGCTCATTGCC	EGR3
TAATGTCGGTGA	JUND
GCCGACGGGTCN	ZAP70
CCCGGACGGACT	BACH2
ATTACCCCCTGN	NFAT5
GAATGAAGTGGC	NFKB1
CGTTCGGGGCCN	NFATC2
ACTTTTGATGTN	JUN
GTTTTCAGCCGG	PTPN6
GACAAGCGGGGC	CTRL
CGACAAGGTTTA	CTRL
TATCGTGGTCGC	NFKB2
CAGGGCGCAGGT	EGR1
AAATGTGTTATA	CTRL
CCCGCGTGCTTA	CTRL
GACGAATAATAA	NR4A1
ATGACGTCCAAC	CTRL
CGCTCAGGTTCT	RELA
ACGTCCCTTCAN	GATA3
CATTTGACACGA	CTRL
CGCAGCACCCGA	CTRL
CACGAGTACTCT	EGR3
TCTCTGGGCAAT	CTRL
CTCGACATCATC	CTRL
TATAACCTAATC	NR4A1
CCATGTCCAACT	EGR4
GTAATCGACACC	ZAP70
GGAGTGTCAAGA	LCK
ACTCTATCATTT	EGR4
GTGTTCGGATCN	JUN
CTTTATCAACTT	JUND
GTGCGTGCTGGT	JUN
CTTTCGCTGTGC	RELA
CCAACCCCGCTC	DHODH
GACCTTCATCCC	NFATC1
ATAAAGGATAGA	EGR4
TACTAGGTAACA	EGR2
CGCCCGTGCCAN	JUN
AATGAACTCACC	TUBB
GATAAGTGCTAC	DOK2
AGTGGGCCTCAA	RUNX2
TGAGCGAGGGTG	BACH2
GCCCTTGTCTGC	NFAT5
TCGCTAATTGTC	CTRL
TGGGGGGCCCCC	CTRL
TTGGACACCGAA	LCK
ATGCATGGGATT	DOK2
GGCCTCAAATTT	LAT
TCTTATATGTAG	NFATC1
CACATATTCGCT	CTRL
TTGGTTACCCAG	NFATC2
TTGATGGTACAC	CTRL
TTCGCGAATCAC	CTRL
CCTTAAGTTCCC	PTPN11
TGGACTTCCCCC	CTRL
ACCGTATTCACC	RELB
CCGGAGTGACGN	BACH2
GTCGTACGCGTT	CTRL
TGGTTTCGGCAC	JUND
AGAGCCTGACGT	CTRL
CCTTGCCTTTTG	EGR4
ATAAGGCGGACA	DHODH
TCATACATCCAC	FOS
CTGACTTTCCAA	NFATC3
ACCTGGCAACCT	CTRL
TGATGTTGTCCT	EGR4
ATCGCAGAACAC	MVD
TATGTACATGAC	PTPN6
CTTCTTAAATCT	DOK2
GATCCCGGACAN	NR4A1
TCTTCGCTTCAC	FOS
GTTTTTATGTAA	CTRL
TGACGTAGACAG	NFATC3
GTGCCTAATGAC	FOS
CACTCCATCGGT	CTRL
TCCGTACAACGA	CTRL
AATTAAGACTTN	JUNB
ACGATGCAACTA	JUND
TTTAACACGAGC	DOK2
GAATGGACCACC	DOK2
TACGATGGGCGC	CTRL
ATGTTGACTGCC	PTPN6
TTATACCTTTAC	ZAP70
CGGAATTTCAGT	FOS
TTCACATGTGTG	PTPN6
TGAGAGACAGCG	DHODH
TTGGATCTACTT	FOS
GTCATAGCCTGA	CTRL
CAACCCCAGGAG	JUND
ATGTTCCTTAGT	NR4A1
CCTTCTGCCACG	EGR1
TTGGCGTGGAAC	BACH2
CGATGGCGTGAN	FOS
CTAACTGGAATA	PTPN6
CCTCCAGCGTAT	BACH2
ATTACGGGCGAG	CTRL
CACAGCGAATAC	JUND
GCAATTCGTTNN	FOS
GCGCGGGATTTG	JUN
GCAATTCCCTTT	NFKB1
ACCATTCGACAG	FOS
TACGTTGACCCA	NFATC1
TGGTCGCCCTGT	JUNB
GGATCCCTTAGN	DOK2
CTAACTGGATAN	PTPN6
AAGCCGCGCACC	CTRL
AGCTGCGGATTA	EGR3
ATTTGTGTCCTC	REL
GGCCACGGTAAA	BACH2
TCGGTAGATTTA	REL
AACTGGAGAGTT	NFATC2
TCCTTGATCGCC	BACH2
CGGGACTGTCGG	RUNX1
CCAAGCTCAACG	CTRL
CACCGGACATGG	NR4A1
TATAACGCAGTA	JUN
TATGGGACGGGA	NR4A1
GCCGCTCCTCTA	FOS
ACTGTCCCTAAN	TUBB
AACTTCCTTCTC	EGR3
GTAGAGACTATT	NR4A1
CCAGGGATTTTT	JUN
ACCCCTGTCTCT	CTRL
GATGAGCACGCA	NFKB1
TAGCAATTACAN	CTRL
ATACGCGGCCNN	RUNX1
TCGTAAAAGGTA	CTRL
GTGATACTCAAT	NFATC1
TAGTTAAGCGAN	RELA
AACGTCCTGGGA	CTRL
TGCGATGCAGTT	NFAT5
TGATGTATAAGC	EGR1
CTCACGCATGCC	CTRL
TGGTATGCCTAG	NR4A1
TGCTTAAAATCC	ZAP70
AGGTCGCTGTCG	CTRL
AGGCAAGTGGAA	EGR1
ACCTCCGTCTTA	NFKB1
CGTTCTTGTTGG	JUNB
TGTCATGTGCTT	BACH2
TTGATGTACACN	CTRL
CCATCCGCCAAG	JUNB
ATTCTTTCACAN	CTRL
AACAATAACTAG	LAT
GATAAAATCGTC	CTRL
CTGCTACTAGGA	JUNB
CGGGGTGCCAGA	CTRL
GTGCGACTTACC	PTPN6
GCGTCTGGAGAC	LAT
GCGGTCTGAAGA	DOK2
ATAGTGGGTTAA	NFATC2
GAGCCAGCGGTN	NFKB1
AAACGGAGACCN	NFAT5
GCGGCGACATTT	EGR2
CATGAAGCAGCT	NFATC1
CGGGAGGGAGCC	NFATC1
GAGGTGGGAAAG	LAT
CTGTGTAAGTTA	CTRL
GACGTTCCAATA	CTRL
ATTGAGACCTTT	EGR2
CCAAAAACGGTT	EGR2
AAGGTAGCTACA	FOS
CTCTGATTTACG	DOK2
TCCCCTCTTCGC	BACH2
TACTACCCGTCC	NR4A1
AATAAGGGCCTC	CTRL
AGGATTTCCTCA	EGR1
GGCCAAGTCGCA	CTRL
CCGGTCCCGAGT	MVD
AGTCACGATTTA	BACH2
ATTCTTAATTAN	NR4A1
ATTCTTAATTAA	NR4A1
CTACTGCAAGGA	EGR3
GAGCAACGCTCC	JUN
CTGATTCAAGTG	PTPN11
GGGACAGTCCCT	DOK2
GCCCCGTATATN	RUNX2
CGCCTAGCCACC	CTRL
GGGAGGGAGCCN	NFATC1
AAATCTACGTAT	NFKB1
CTTGGGTATTTA	NFAT5
ATTCGTGCACAG	NR4A1
CGGTCGTTACTG	CTRL
TACAGGCTTGTT	JUND
CATAGACCTAGA	CTRL
GCTGTCAATCAC	CTRL
ATTCCGATGTTN	FOS
GAAGCTTAGGCG	CTRL
ACTGATGACGTC	EGR3
AGATGTGACCAG	NFATC1
GTTTTTGGGCTA	REL
AAAATCTGTGCT	PTPN6
TCCTGTCCTCAC	RUNX2
GTGGGGTCCATG	RUNX2
TCAGTCCTCTAT	NFATC2
ATGCAGATAGGA	EGR1
CGTCCGCCGGGA	NFKB2
AACTCGGAAGTT	JUNB
TATATTAGTTCC	NFAT5
AAAGCTGGTCTN	RELB
TGATGCGGTAGG	JUND
TCCACTAATAGT	NR4A1
CCTACTTATGTA	JUNB
CTCTCTTCTTTA	ZAP70
TTTCTAGGACTA	NFATC2
TCGGTCACGATG	CTRL
CAAGCTCTCTAA	EGR3
CCTTTGACCGGA	NFATC3
GTTACTGACACT	CTRL
GTCTCATGACAC	JUN
CAACGCTACTGG	PTPN6
CCCCGGCTGCCC	RUNX2
TGACCACTCCTC	JUNB
GTCCGTTCTGGA	JUNB
AATGCTCCCTCG	NFKB2
CGCCACCCCAAG	CTRL
CGAGCCGATCCG	BACH2
CATTCTCACCTC	REL
TTGCGAGAAGGT	ETS1
AGCGCGGAATCG	CTRL
GTTTAATGGGTA	DOK2
TATGCGTCCGAG	CTRL
CGAAGTGGAGCG	RUNX2
CGGTCTGTAAGA	EGR1
CGTTCAACTCGC	PTPN6
GCCGCGCCATAC	MVD
TCGAATCCCATA	CTRL
CGCAAAGCGCAA	FOS
GGGTTTATGGGT	EGR1
CGCCGTAGCGAT	RUNX2
GAGTTTTCGCAC	REL
GGACGATTCACA	JUNB
GCGCATAAGAGC	JUND
ACCCTAGGCGTT	CTRL
GCGTCCGAGCTC	BACH2
ATAGGTGACACA	PTPN6
ATAGGATATACN	CTRL
CTCGATCCTCCT	LCK
CTTGCTGTGCAG	CTRL
AGAATAGAACTA	CTRL
CGACGTCAATGG	DOK2
GAGGTTGATGCT	JUNB
CATCGAGTATGC	PTPN6
TCGTTTAGTCTT	CTRL
TACAAAATCTCT	NFATC1
TTGGCTGCCTAA	FOS
TGGTATAACCTT	NFKB2
GCAAGCTCATTN	MVD
AGCATACAAATG	CTRL
TGTCTTGCCTAC	CTRL
ATCAGAGCGTGG	JUNB
TATCATTACCTC	CTRL
AACTCACCAGCT	NFKB1
ACTGGGATAGTC	DOK2
TCACCGGATTCG	RELB
GCATTATCTTAT	ZAP70
ATGCATGACATC	LAT
AACTCACCACTA	CTRL
GAATGATCGCTC	BACH2
AGCCGAGTTCCC	FOS
AGGAGCTCAGAT	NFKB1
ATCGCTTCTTGA	LAT
ATTATGTCAACG	CTRL
AGCCATGCTAGA	JUN
GATTTATCATAG	EGR3
TCCATTTTAGGA	DOK2
TACGTGAGGGGC	EGR1
AAAATCTACTCT	RUNX2
CGAATAGCCCGG	EGR3
CCGTGTGCATTT	RUNX1
ATATTGCCCGTA	RUNX2
CTGTGGTTGCCT	CTRL
CGTGTCTTTCTA	NFATC2
TTAAGCAGAATT	RELA
TACGAAATTTCC	RUNX2
TCTAATCCTTGN	FOS
AAATAAAGTACT	REL
CGTAGATTAACA	BACH2
TGACAAAGTCTC	LCK
CTGTAGAAGGGT	CTRL
ACTCCGTGGGTG	DOK2
ATTGGAAAGTAN	EGR4
TCGGGACTTAAC	ZAP70
AGGACAGCCCGT	CTRL
TTGTGAATTCTA	NFATC1
GATGCAAGGGTA	MVD
ACATCATCTTCN	ZAP70
CTTGCCTTAAAT	RUNX1
CTTGCCTTAATN	CTRL
TCCTGCCGAGTT	PTPN11
CTCACATGAAGC	ETS1
TTCATACGGCTT	CTRL
CAGTTTTATTGC	NFKB2
CCGGTTGATTGT	PTPN11
CGCGGGTTCATA	CTRL
CACACCTACATG	FOS
CCCCCCGGTTGC	CTRL
TGCAAAGGGCGT	EGR2
CCTAGTGGGCAC	CTRL
TCCCACGTTAGG	NFATC3
CAGTTTAGCCAA	CTRL
CCGACCCTTAGC	CTRL
CTATGGAGCAGN	EGR2
CGTAAAGAGCTA	DOK2
GACCCCGACATG	NFATC1
AAACAATGTANN	BACH2
TAGCAGACAGGC	FOS
GGCACGGGAAGA	EGR3
GGCACGGGAAGN	EGR3
GCACTTAATTAG	PTPN11
GATAGCAACGGT	NR4A1
TGCAAGTAGGCC	GATA3
TAGTGTTTCGCA	NFATC3
TGCGTGCTTATC	JUND
TACTGCGTACAC	FOS
GCCGGCCGAATT	RELA
CATGCGGCCCGG	CTRL
GAGGAACTATAG	LAT
ATTCAGCTGACG	CTRL
GCCTCTAAATCA	NFKB2
TCGAAGACAGTA	EGR1
ATCGTCTGTAGT	CTRL
TGCCTTACGGAA	CTRL
GGCCAGTAAGCA	CTRL
GCCCCAGCTGCG	NFATC1
CAGACAAGAGAG	EGR2
CACGTGCCCGAN	CTRL
CATGTAATACTC	JUN
CGACGCAGGTCA	BACH2
TCGGGTGTCTGT	DOK2
CACGATTAACAC	EGR4
GTGCCCAAAAGG	PTPN11
GGTGAAACGGAG	FOS
ATCTCGTCGGAC	NFATC2
CGTGATTAGTAA	REL
AGTTGTGGATTA	RELB
GTACTTGCCCTC	PTPN6
AATTACCGCTGC	CTRL
ATTGTTGAGAAC	LCK
TTACCTGTCAGA	PTPN6
CACGAATGGCAG	REL
TGTCCACACCAA	NFAT5
CATCCCCCAATT	NFKB2
CGTCGTTTGTTA	GATA3
AGCGACGACATT	NFATC1
CCAAGAAAAGCG	ZAP70
TGACATGTCACN	JUN
GTAGAGGTTCCG	NFKB1
ACAGCGAATTTA	BACH2
GTCCCCCCCCGC	JUNB
TTATGGTCGGTN	JUND
GTGCCTCTCGTC	LAT
GTAGTTCAATCT	EGR1
TGTTCGGCACTG	RELA
AATCCAAGCGTC	CTRL
CCCATCGTTTAG	JUNB
TCCACCGCATCT	PTPN6
GCACGTGCCTGG	CTRL
TAGAGTTAGTCA	ZAP70
CCAGTTTTTTAT	JUND
GAATCTAGTAGA	RELA
TCTGTTTTTGGT	EGR2
AGTGTCCCCCAA	REL
ATAATGCGCAAC	CTRL
GTAATCTAGGAN	EGR1
GCAAGCCCTTAG	NFKB1
CAAGTCGGGCTT	RELA
GGTTTTGCCTCC	PTPN6
AGTGTCCCGCTN	EGR2
AACAACAGCTCT	JUN
CGCGTAGTTGGG	NFKB1
CTGAGATTCCTG	NFATC1
AAGGCTGTCAAC	NFATC3
AAGAATCCAGTC	CTRL
ACCTCGAGTAGC	CTRL
ACCGAACTTGAA	RELA
AATGCAACTAGG	FOS
GCCGGGTCAATC	BACH2
ACGTGATTATGA	NR4A1
TTTACAAGGCTA	NFATC3
GTCTTCTCAATT	CTRL
TTAACACACATG	CTRL
CAGTTGGTCCGT	EGR2
CACGTCGCTTTA	GATA3
TTATAATTCCTC	ZAP70
CATCGGTCCACG	RELA
TGTGCCATCCCC	DHODH
CATTACCGAGAG	NFATC1
CCCCGCTTCTTC	BACH2
TCGCTGCGCTCC	NFAT5
ACACGTGATAGA	CTRL
GCGCATGTCCTC	LAT
GCGTCCCCAATG	CTRL
AGATAAACTTNN	CTRL
GAATTATGAAGC	NFAT5
GGATCTAAGGTC	BACH2
CGACGCGCCGTA	RUNX1
TACTGCTAACCA	EGR1
CCTGCTAAGGAT	EGR1
GTGATCTTACAT	NFAT5
TGTGTGTGAATN	NFATC1
CCGCGGGCGCTA	CTRL
CGCCCCATACTN	BACH2
CTCAACTTGATC	FOS
AATTCTCTAACC	LAT
TCCATAATTGTC	JUN
TTGTACATTTCG	CTRL
TGCGGTAAAGAG	CTRL
CCAGCCGAGTAG	EGR4
GTTGTGTCCGGT	EGR4
TTATAAGCATCG	PTPN11
AGGGAACCCTAN	CTRL
GCCAGATCCCAG	CTRL
TCGTCATAGATA	EGR2
CCCTATATACTC	CTRL
TGAACATCACTN	JUN
GTATGGCATAGG	RELB
TGCTCGAGTATC	NFKB1
GCGGGAGTCGCA	RUNX2
CACTGGAAACTC	NFAT5
CAAAATGACACC	REL
GCATGATCCCTN	BACH2
TAGCAGTGAAAC	CTRL
GCGATAAGCATA	REL
GATAATTGGTGG	LAT
CGGTATATTCTA	FOS
TAATTGCTGCTA	JUN
CGTAAGCGATGT	REL
GCTAGATCCCTC	BACH2
AACCCCCAGCGG	JUND
CTAAGGATGCAT	NR4A1
TTCGCTTCACTC	LCK
CTCTTAGAATGT	ZAP70
TGGGGAGTTGAT	PTPN6
TGGATTCGTCAC	FOS
CGTTTAGCCGAA	EGR3
GTACGGGAGTGC	DOK2
AGCTCCGATTGA	NR4A1
CCGAACGATTAT	JUNB
ACGGTAGATAGA	JUN
GCAATATAGTCC	RUNX2
CTAGCCGGCAGC	PTPN11
CAACACCGCGAC	RELB
CGCACTTACCCG	NFATC1
CACTACAACTAT	CTRL
ACTGGCATCTTC	NFATC1
AGTCTATCCAGT	CTRL
CTTGTAAGGGAC	NFKB1
TGCAAGGGGGCG	BACH2
TTACGAGAGATT	CTRL
CAGCGACAGAGA	EGR4
ACCTTATCTCTN	RUNX2
CTTCCAACCACA	CTRL
CCCTCCAGCTTA	CTRL
TTCGAAGCTACC	CTRL
TTGTCCGGGACN	CTRL
TTCAGCTCCTGA	CTRL
CTTAGATGCATT	RUNX1
ATGGGTATGTGT	NR4A1
TACTTCCGCCGT	CTRL
AGCGTCATACTC	CTRL
CTCATAGGCGCG	PTPN6
TCGCCAGCGCGG	MVD
GTAGCCGTGACG	PTPN11
CTCCGGGGGTTT	FOS
CAAAGTCTGGTT	CTRL
CGACCGTGTGAG	CTRL
CATCTTTACCAA	NFAT5
TCGGTCCACCGC	REL
CGTCAGCTGGGC	CTRL
ACGGCGATTTTT	BACH2
GGACCTTCTTGT	NFKB2
GAACGGGGTGGC	CTRL
CGCCGCCACGCN	GATA3
AGGTTGGGGCCG	CTRL
ATTTAACTGGCA	JUNB
TCGTGATAATTT	BACH2
GCATCCTGGATC	NFKB2
CCGATAGACGTA	NR4A1
CGCGCCAGTGCC	PTPN6
CATCCTTTTTTN	CTRL
TGGGACATGGTC	REL
TCGCGGGGCTTN	NR4A1
GCAGTCTCATCA	RELB
TCGTACCGTATC	CTRL
GTATCGGGTGTT	EGR1
TGGGCCATAGAT	EGR3
GATCTGAGGTAA	PTPN6
CCCGCAACCAGC	JUN
TGCCCGGTCTTT	CTRL
GTCTTCATAGTA	LAT
AGAATGTGCCTC	CTRL
TAGATAACACGT	LAT
CGTCGTTGACGA	FOS
GCGCGCCATACG	JUN
GGGTAGGCTCCT	ETS1
CAGAGGGTTCCG	EGR1
TCTCCGGACAGT	RUNX2
GCTGCACTCGAG	REL
CAAGGAAGCTTT	RELB
GTCCACCCTGTA	CTRL
GCCTGCCAGCCG	REL
TTTGAGGACTGT	NFATC2
ATTCTACCTTAC	CTRL
CGGCGCCCAATG	RUNX2
CCTTGCCATAAT	EGR4
AGATGTTAAATG	EGR2
TCCTAGAGAGCA	CTRL
TCGGGCTTGAGT	PTPN6
TCATCGCCAATA	BACH2
GTGTACGACTGT	LAT
AATTGTAGCAAG	REL
CTTCAAGCTTCA	PTPN11
GCATCAGGATTA	PTPN11
CAGAAACGCCGT	DOK2
AATAATGGATTA	JUN
CTTTGTGCATGG	LAT
TTATAACTTATC	RELB
CCCTGTGTCTGA	CTRL
AGATTTCGAACG	ETS1
CACCAAGCGTGT	RUNX2
ATTCGACGAGAT	NFATC1
GTTTGCGAACCT	CTRL
TTAGGTGGTTGA	PTPN11
TTCGAGGAGGCN	REL
TGTATGTGAATT	DOK2
TGTTCGTTTCCN	BACH2
CGTGCGGATTTT	NFKB1
CGGGGCCTAATG	EGR4
GAGTCTTAAATC	LAT
GGCTTCGTGACT	CTRL
TGTGTAGTGGCC	CTRL
ATTTGTGAAGAA	REL
CAGTCTGGCCGC	JUND
ACCTTGCCTTTC	ZAP70
GGGCATGACACC	CTRL
GAGGTGAAGTCA	EGR1
TAACCTTCGTGC	EGR1
GTAGACGGCCCN	JUND
GTATCGACCTTG	DHODH
GCCCCTAGACAC	GATA3
CCCAGTCGCGGC	NFKB1
CTGTGAGTGCAA	FOS
GTAGCTGATCGC	BACH2
GTCGTCTGTAGT	CTRL
CCCTTCGATAAC	EGR1
AGGGTTGAGTTC	CTRL
GTAAGGTACACC	FOS
CAAGATTCAATA	JUND
GGCGAGTGGATT	CTRL
ATCGAAAGCTAC	JUND
CGTCTCGAATTN	EGR4
ATAACCGGGCCC	NFKB2
GCTCTTGAGATT	EGR1
TGAACTTTAGCA	PTPN11
CGTCGGATTGTT	REL
GTAAGGCAGCTC	CTRL
AAATGTCACTCC	JUNB
GCCTCACGCACG	JUN
CACGAGCCATGT	NR4A1
CTGCGTCGGTAG	EGR2
ACTGGCGTTGGA	EGR2
ATTAAGCACCTA	LCK
AGTACTGGGACA	LCK
CTCTTGGACGCC	RELB
GCCGCGTATGTT	CTRL
GAAGAATTCAAA	FOS
GTTAGGTTGACT	FOS
TGCGTTTTACGC	EGR4
CCGACAAGCACA	JUNB
CAAAGTGCGGCG	NFATC1
CCCAAACTTATG	GATA3
GGCCCCATCGTC	CTRL
AACGCCTGAACC	NFATC3
ACGTTGGTGGCG	REL
TTCCCTAAACTG	PTPN11
TCGGCACCTGCA	FOS
GGTGAATCCCAA	JUNB
GGACTCATAGTC	NFKB1
GCAATCCCCTTN	CTRL
ACGCTGCTCCAC	JUND
CAGTCCGACAGA	PTPN6
AGGTAGTAGTTC	DOK2
TGTCGCGCTCCT	CTRL
AGCTCTAACGCT	CTRL
TGGAACATCACT	EGR3
TTGGCGGCAAAA	PTPN6
GCCAAGGGATGG	EGR2
TTCTTTTTTTCN	ETS1
GTGTTTAACAAT	CTRL
TCCATTACTCGA	GATA3
CGAGGAACAAGT	BACH2
GTCGGTCCTTAC	CTRL
TTATCGTTCGAC	EGR1
CTATTTGAGACA	NFAT5
CGATCGGCTGCC	EGR1
GACTCGCCACTT	NFATC2
GGCGATTATGGC	ZAP70
GGCGCCACAACN	NR4A1
ATTTTCGGTATC	REL
GATCACGTGTCT	JUND
TAGCAATACACT	NFATC1
CGCAAGCCATCC	JUND
CTAACAGAGCGG	FOS
CATTATACCAGC	CTRL
AGACACATCTAG	RUNX2
TGGTTCTGGCTG	CTRL
GTATCGCGCCGC	CTRL
ACAATTCCGCGC	CTRL
ATAGCGAAGTGT	NFAT5
TTGCATGACCTG	PTPN11
CCGCGGTGGACG	NFAT5
TTCTTCTAAGTC	CTRL
GCAAAATCGCAA	EGR4
TTTGCTCCTCCG	FOS
GTAAGAGGGCCC	PTPN6
TCATGCCGAGCA	ZAP70
CATTGTCTCCTG	CTRL
TGCGCTTAATGG	NFATC2
GAACCTCATCCC	DOK2
AGCGAAGGGAAA	NFKB2
ATCGTAAACCCA	NFATC1
CAGACTGTCCGT	CTRL
GGTTGCAGTGTC	CTRL
CGACACGTATGG	NFATC1
CTTACCGAGAGA	NR4A1
CACCAAACGATC	DOK2
CATTATCGACTC	CTRL
CCTCTTGTCTGT	PTPN11
GCATCTCGCTAA	PTPN11
CCGTAAGATCTA	PTPN6
ATTTGTTGATTG	EGR1
GGCACCAGGGAG	RELA
ATAGATAGAATT	NFATC2
GCGGGCACTGAC	NFKB2
GTGGGGACATCC	BACH2
CGGGGCTTCATA	NFATC2
CCGAAAGGTATT	CTRL
TCTTTAAATTGC	NFATC1
AGTCTTGGTACA	PTPN11
TTGGCATGCACC	CTRL
GCTACTGAGACG	FOS
CTGACGGCTGTC	CTRL
TCCTTATGTACG	JUN
TTCAACAGGAAT	PTPN6
CCTTGTTACTAC	PTPN6
CAATCTTAGCGG	PTPN6
GGTCGCTCCGAG	GATA3
CGACAGTCTTTN	LAT
ATGCGCTCTCGN	DOK2
GATCCTGAGGCC	RELB
TAATGCCCGGGT	DOK2
GGAGCTGATCCC	JUNB
ACAAAACTAGTC	CTRL
CTGGGATCCTGG	FOS
GCAATTTTTGTC	NR4A1
ACTGAAAATGGT	RELA
GATGCGCGGCCC	EGR2
ACGGTCTTTCCC	ZAP70
GGTTTAGCGGTG	REL
TGCTAGTCAAAT	CTRL
CTCTTAGATGAT	JUN
TAGCTCTACGGG	ZAP70
CATTCTGCGTCT	REL
AGCTCCATGCAC	JUN
CAAGTTCTACTA	NFATC1
AAACCCCCGCGG	NFATC2
ACGTTTACCTNN	NFATC1
GAGGAGCTTGGC	EGR1
ACCGGTATACAN	NFATC2
GTCTCTGAACCC	EGR1
CAGACAGCTGTT	DOK2
TATTGTGTGAAT	RUNX2
TCATTAAGTNNN	NFATC1
AGCGCCTCCAAC	EGR4
TAGATGCTTCAN	CTRL
CCGACGGGGATT	RUNX2
TCGACCAACCAT	JUND
GAGATTGGATTG	DOK2
CCCAGGCTACCG	LCK
CTAATACCTGAA	CTRL
TTTGACCTTGGA	CTRL
TAGCTGGGGCGG	NFKB2
TGAAGAATGTGA	CTRL
GCGTGGGGGAAA	PTPN11
ATTCAAGTGAAT	LAT
GTACACTGTCAA	FOS
CAGTTCCCTTCT	CTRL
GTGACGGACCTN	BACH2
CACGATGCCCGA	CTRL
GTCGATTTGAGA	CTRL
TAGGGATTAAAT	ZAP70
TGCGCGTGAAAG	ETS1
TGACAAATCCCG	JUNB
CCATGTAAGTAA	FOS
GTCTCTCGAATC	NFATC2
GCGTACTATGAA	JUND
GTTCATGTGTTC	JUNB
GTCTCCCCGAGA	ZAP70
AGAACATGGAAT	ZAP70
GAGAAAGAGGGC	CTRL
ACCTAGATATAA	EGR4
CATCCATGAAAT	CTRL
TTCGAGCCCTAC	FOS
TACCCTCTTTGN	EGR4
GACGATGGGGGG	EGR3
TTACGCGAAACC	LAT
AAGGCCAAATAT	EGR1
GACGTTCTTCGG	EGR2
ACTATTCTGTAA	NFATC2
AATACTAGCTTC	ZAP70
GATGCGGCTTTA	CTRL
ATTAGCGCTCGC	JUNB
AACCGTTCCCTC	EGR2
CCGATGAACAAC	TUBB
TGGAGCTCGATC	EGR1
CAGCCCCCTCTG	PTPN11
CGCTGTGACCAA	NFAT5
ACGAATCAAATC	CTRL
GCACGGGCAAGC	EGR4
GCCTGAAACATC	PTPN6
AAAGCTCCTACN	FOS
GGCAACCTTATC	EGR3
TACCTTTCGGTC	NFKB2
TAATTAGTATAT	CTRL
CTCGGGTACGTC	GATA3
AAAATCTGACCA	GATA3
CACCCTATACGA	CTRL
GCGCGACGTGGC	NR4A1
TCTACAATTAGA	NFATC2
CGTGTTTGTTGC	MVD
ATTTCGTTGAAA	CTRL
ATCCCATAAGCA	EGR3
TAACATGGGAGA	CTRL
ATCCCAGTGCTC	EGR4
CTGACATAAGAC	CTRL
GGTCCGTTCTTG	LAT
ACGATCGACGAT	JUNB
ATTAAACTCGCG	MVD
CGAGATCATGGN	NFATC1
ATAGATTTCTGG	LCK
CGTAGCAGTGAT	DOK2
CTCTCAACCACG	NFATC2
AACGTTCCGTGA	RUNX1
CTACGTTTTCAC	CTRL
CCGCGTTTAAAA	RUNX2
CGCCGATGAACC	EGR4
GCGTGGAGGTCC	PTPN11
GGTCCGGGTCTG	CTRL
CCGTTGTAGTCG	LCK
TCTATCCTAACC	JUN
TTCTGCTGAACC	CTRL
CTGCACGCAGAT	EGR2
GGCCCTTGTAGC	JUNB
ACTGTTGAGTAT	NFATC1
GTTCTACCTTAC	CTRL
ACACGCCGATTA	PTPN11
GGGTCGTGTCTA	CTRL
AGCCTGTCTATG	GATA3
ACTGAGCGTTTN	NR4A1
TGCGCATCCACT	JUNB
CTAGACTTTGCC	REL
TTCTATCGAGGC	RUNX1
GATGGGAAACTT	EGR1
CTTCAGCCATGG	EGR3
CCTCACTAGANN	NFATC3
ACTTCTGCCACG	CTRL
GGACTGGCATAG	RELB
TAAGAGAGACGA	JUNB
TTCTTGGCATTT	FOS
CGACTGCGGATN	CTRL
CTCAACCCGTAA	NFATC2
GCAATCCCTTNN	CTRL
ACGTGTGTTTCT	REL
TGCTTGAGGCNN	CTRL
AGTCAACAGGGT	FOS
TTTTTTTCAAGA	CTRL
GTCTGGTAGCGA	CTRL
CGTGGGATAACT	LCK
ATTCATGCAGGC	FOS
TTTCGAGCAGAT	CTRL
CACTAGCTAACA	FOS
CCACGTGGCGAT	FOS
ATGCGCAGGATC	RELA
GCCTTGCCTTTC	ZAP70
AAACGCGTACCA	CTRL
TATTCACAGACA	NR4A1
ACGAATATCCAC	NR4A1
TTATTCGATATC	CTRL
CAGATTAGTCCC	FOS
GTAACTCACCAT	PTPN6
CGCTTGTGGTCA	NR4A1
CGGAAGTCATCC	JUNB
CCAATATGGCCC	CTRL
ATAATCCACCGC	EGR4
TCGCCATGTAAA	FOS
CACGCTGAAACA	CTRL
ATTTTGGTCAGG	RELA
CTTACAATTCAC	NFKB1
AATAACGATTAA	PTPN6
GGGAGTGTCCGT	NFKB1
CCTCGGTCTGTG	CTRL
AGGATCATGGTA	RELB
CCCTAACATATG	BACH2
CCACGCGAACAA	RELA
CCGTTCGTCATG	CTRL
GCTAGACTGGTC	NFKB2
TCCGCAGAATGA	PTPN11
TCCGTCGAACAC	CTRL
TGGGATTCTCAT	RELB
TTCCGGAGCTCT	NFATC2
AACAGGCGTGCA	LAT
GTGGTTAAGAGA	LAT
GTCGAAAGCTAC	JUND
TCTGGCATAGTC	JUND
CTTCACTTTTTG	NFATC3
GGATTCTCCAGC	NFATC1
GTGTTTCAAATG	TUBB
CGCAAGATGGAC	NFKB1
GTCCGTGTCTAC	LCK
CGGACCAAAACT	MVD
GATCCACGCGTC	JUNB
CCCCAGGCAAAA	RUNX2
ACCAACCGACAG	CTRL
AAGAGTGTTCAA	BACH2
GCACGCAGGCAT	CTRL
CTGGTATGCGTG	EGR2
AACACCGATTGA	NR4A1
TCCCATACAGCG	PTPN6
CGATATACCACG	JUN
GAATACACACAC	EGR3
TGCGAGAATAAT	JUND
TGTATTGCGGCG	CTRL
CCACGCCGACTT	CTRL
TCTCTTCCACGC	FOS
CGTTCAGACACC	JUN
ATTACCGTGTGA	REL
CAGCCGGGTCAC	CTRL
TACCCGAGATTC	LCK
AGGGGGGTGAAN	CTRL
AGCTTGCCGACN	JUNB
GTTGTGGGTCTA	NFAT5
CGGAGTGGATAT	FOS
CCGGGTGTCGCT	JUND
TTCGATGCGCTA	NFKB2
TGCATTGAAGAA	NR4A1
AACTATCACTGT	NFKB2
ATGTGCCCTGAA	RELA
GGAACAGAGACG	NFATC1
GTGTCTCGCCGC	NR4A1
CTTCATTTCTCT	RUNX1
AGCTACTTCCGT	REL
TAGATCAGTTTG	CTRL
ATGTATTAAGGG	EGR2
ACGGCCACCCAN	CTRL
TAATTCTGCATA	CTRL
TGATTCGATCTT	LAT
ACGGTCCCGTGC	DOK2
TATCAAACATNN	RUNX2
GCTTTGGGAGGC	NFKB1
CAAACTCAGCTG	NFKB1
GCACGCTTCTAT	CTRL
AGCGGGCATTTC	REL
CATCTGATCATA	NR4A1
TACCCTACTCTA	JUN
CGTTCTGTAGAC	EGR4
ACTTCTCTTTCC	BACH2
GTCCTCCGTGCA	CTRL
AGGTGCTACGCG	RELB
TCTGCGGCCTGC	PTPN6
CTCGATTCATTA	NFKB2
TCTACGCTATCN	FOS
ATGGGACTACAC	CTRL
TTTTTGGAAGTT	CTRL
GCTTAGGTACCA	CTRL
GGAATCTGAAGN	CTRL
TATCACTCTCAC	CTRL
GGTGATCGCATC	LAT
GTTGCCGTCCGA	FOS
GACAGGGAGCAT	CTRL
CTAGGGCCACGC	CTRL
GCTGTGATCCTN	NFKB1
GCGCATCGAACT	FOS
ATAGATACGTCC	NR4A1
GCTTGGTGCTCC	CTRL
TATGTCTCCGAT	CTRL
CTCCCTTTACAA	NFKB2
CGCGCAGGTGCG	JUND
CAGATTTTTTAN	EGR1
GCCTCCAAATAC	CTRL
CTAATGTCTGCC	RELB
AGCTGTCCGTAC	NFATC3
GGGCCTCCGAGA	CTRL
CCCTTTTCATGC	NFKB2
GGGTACGTCCAG	BACH2
TCCGAGCTTCTA	EGR1
GTGTTTATCGCG	JUN
AATCTCCACCTG	RUNX1
GTAACTATGGTT	JUNB
TCCATGAAGGGT	LCK
GCGTTTACCTNN	NFATC1
GTTGACTAATAN	LAT
GCGAACGTTAGC	ETS1
CGTAGGCACGCN	CTRL
AACTACCTCGTC	DOK2
TACAGAAACTTC	CTRL
CTGTACAGACCT	CTRL
CACCGCTTAAAA	CTRL
ATTGTCTTTCTC	MVD
ATCGCAAACTAC	EGR3
TGTCTATAATTA	LAT
CCAAGTGAGCCT	BACH2
ACACCCTGTTGC	MVD
CAAGCCGACATG	FOS
TGTTATTGAATG	EGR2
TAGAATGTGATC	EGR1
TACCTATCCCCC	CTRL
GTTACTGCGGTC	NFAT5
GGTCGATGCTGA	CTRL
GGTCGGACACTC	NFKB2
GTATTGCTGGAG	PTPN6
GGGTAACTGGCT	ETS1
CTGCGCGCAACT	JUNB
CCAAGTTGCCTC	EGR4
GATCACCTGCCC	REL
TATGTAAGGCAG	RUNX2
TAAGCCCATCTT	JUNB
TGCCATTACTTN	EGR2
GGCGCCTGTATC	EGR3
TATTATGACCTA	NR4A1
TATCGCCAGACG	EGR3
CGGACGATAGTG	CTRL
CTATAAGCCCCG	FOS
TCCGTTCTGTCA	BACH2
AGAGGCAACGAA	CTRL
ACCGAAATTTTC	EGR1
TCGGGCGTGTAC	DOK2
GATTGGATGAAT	BACH2
TCCCTACGGTCC	GATA3
GACAAGGTCCTG	RELA
CGCCTAGGTGAT	JUND
CAACGATTCGAG	JUN
AAGGCCCAATTA	NFATC3
GGGCGACTTAAG	RELA
AAGGATAAGGAT	FOS
CGATCTGAGCCC	ZAP70
GCAAGAGTTCCC	DOK2
CAATCCGATTAT	CTRL
GTTTCAACGCGG	CTRL
TGTCCTGTGCAC	ZAP70
GCGTAGCGTACA	NR4A1
GGGATTTTTTTC	BACH2
AGTGTGCCACTT	NFKB2
GCGATAGTCATG	CTRL
CAACCTCGTGAN	NFAT5
AGCTCCGGTTNN	LCK
ATGTCCAGGAAA	CTRL
GGAGTTACGGTG	EGR1
AAGGCCCACAAT	LAT
GTCGGCGTACAT	CTRL
TTAACTGTGATA	CTRL
CCATGGAAACCA	EGR3
TCGCGATAATGT	NFATC2
TCTTCACACAAN	ETS1
TGTGGGCGTGCA	RELA
GCTGAGCCCGGA	JUNB
AATGTTGGCTTT	EGR4
ACGGGAGTCGCA	RUNX2
CTAATGAGCATA	CTRL
GTGCAAAATAAG	FOS
GTTTGCTAGAAT	ZAP70
GATCTGTCGTGA	ETS1
TTCATCATGTAT	BACH2
GTCTGAACAGCA	CTRL
TCCGGGGGTACC	NFATC2
CATCGACCCTTG	EGR4
CTATGAAGCGCC	EGR2
GTTCGGTGCGAA	NR4A1
CTTCATCGAATC	CTRL
CGGTTCCGAAAA	CTRL
GAGACTCATGTC	PTPN11
CAGCACGCGTCT	REL
CGCATCCTGGGA	REL
AAGGCTAACTTT	CTRL
AAAAACAACTTT	CTRL
GCTGGGTTTGTT	CTRL
CGCTAGGCTTAC	CTRL
TTAGACCTTTCG	NFAT5
CGGATAAAACCN	BACH2
GGCGTGCGCCGC	NFAT5
TGGTAGTCTCTC	CTRL
TACACCACCCGT	EGR4
TGATGACCCTCG	BACH2
GGACATAATAGC	CTRL
CGGCACCGGGTA	NFAT5
CGCCGACAGATT	NFATC2
AAGTTCACGACA	EGR2
CCAGCCCTGTCC	LCK
CAAGTAGCCACG	EGR4
CGTCCTGCCATG	ZAP70
GCCAAATCAAAT	CTRL
GTCATTATAGGC	CTRL
TTGTTTTAAAAN	CTRL
GTGTGTCGGGGA	CTRL
TTTAGTATTCCA	EGR1
GGCGCCTAATCG	CTRL
GCTGAGCGTTTN	NR4A1
ACTCGCAGAGAT	REL
