x
TACTTGACCCCN	CTRL
TTACAGCTGAAC	JUND
CTAAGGCCCTTA	BACH2
CTTGACGCAGGT	NFKB2
TAACCCGTACGC	JUN
ATCTAGATACNN	CTRL
CTATCGTTCTTN	NFKB1
GTATTGCGAGCN	JUND
GTACTGTGTTAN	JUNB
CGTCTTTCANNN	NFKB2
CAGTTTATTCAC	GATA3
CTTGTTGCCTGT	GATA3
GCATCAGTAATN	CTRL
CCGCCAGCTCTC	NFATC1
AATCTTGTAGGG	BACH2
AAGCCACCTGAN	RELA
CAATAAGGTGNN	NFATC1
CCAGGTTACTTG	ETS1
GATCAGCCCGAG	JUND
TGATGGCGTGAA	RUNX2
GTCTAATGTCNN	CTRL
TAGTATTTTCCN	NFATC1
CGGCTGCTCATN	RELA
CTCCGCCCCTGN	RUNX1
GTTCTACGATNN	NFKB1
CTCGAGACTTGG	CTRL
TACTAACGACAA	CTRL
CGCATATCGTAA	FOS
GCACCCTCCCCN	JUND
GATCAGAATNNN	CTRL
TTATTTATATAN	NFATC1
GTCGTTTTAACN	CTRL
CTAACGTCTCAN	CTRL
TGACGCTACNNN	RELB
GTCTTAATTCNN	CTRL
TCAGTAGTGCGN	LCK
CTGCTATGAANN	NFKB2
CGGGTCTTTCAN	NFKB2
GTTCAGATNNNN	NFKB1
TCTTCCCCGCAA	JUND
TCTTCCCCGCAN	JUND
CCCCCTCTCCNN	NFATC1
ATCCATTACTNN	CTRL
GACCGCCGCCNN	ZAP70
CTCGTCATACNN	EGR3
AATCCAGCATNN	EGR1
GAATTGCGAGCN	JUND
CTCTGCAACACN	DOK2
CTAGGCCCTTAN	BACH2
CTTACACCCCCA	CTRL
CCGGGGCAGCTN	CTRL
TGCTAGAAGAGN	JUNB
CTTTGATAGANN	JUNB
TTCTTTCTTANN	RELB
CATTTATTCACN	GATA3
ACCAACCATANN	ZAP70
ACGTCCCTCAAN	CTRL
AGCGTCCCTCAA	CTRL
GCACCTCGTTCN	CTRL
CCCCGTCTCGAN	CTRL
CCCCGTCTCGNN	CTRL
TCAAGGTTAGNN	CTRL
GTCCTTGGAAGN	NFKB2
GTCCTTGGAANN	NFKB2
CATTCTGCATGT	PTPN11
TGAGTATGCANN	PTPN11
ACCAACCTANNN	ZAP70
GTAGTTGGGTGG	DHODH
TTTGCGCGGNNN	CTRL
ATGAATAGGGCN	EGR1
CTCACATACCNN	NFATC1
CTCGTCGGCTNN	JUND
CCCGTTTTCNNN	NR4A1
CCGAATACTGCN	RELB
CTTAAGCACGGN	JUNB
AACACCCTTGAC	CTRL
TCCATTGTACNN	PTPN6
TTGCTTCACGAN	LCK
GCGCGAACTTAN	DOK2
AAACGGCAGATN	EGR1
CTTACACCTCNN	JUNB
TCACGGTATAAC	CTRL
CGTTACCCTATN	PTPN11
ACTCATCGTTNN	JUNB
TCCGCTACTCNN	PTPN6
GCTGTCACGGAG	JUND
TATAATCACANN	CTRL
AATCATTCTACG	RELB
AATCATTCTCGN	RELB
ATCGTAGATACN	CTRL
CGCCGGACCACN	GATA3
TCTCTATTCTNN	NFKB2
CATATTTTTAAN	FOS
TCTCTATTCTAN	DOK2
AACCCCTTGACN	CTRL
ACTTCAGGACCN	NR4A1
GTGAGTCAGANN	CTRL
CATGCACATTCN	EGR2
CAAACATTTACN	RELB
CCCCGTTTTCNN	NR4A1
ATGCTTACGGNN	PTPN11
TTACGGTGTATN	ZAP70
CGTGACATCTNN	PTPN6
CGTGACATCTGN	PTPN6
ATAGACCGTCAN	NFAT5
GTGAGGACGTCN	FOS
CAGGTTACTTGN	ETS1
TTCTATTGCTNN	BACH2
CCGGAGTGGAAC	EGR2
CATACAATGTAN	RELB
ATTTGGTTGTGC	CTRL
CTTAATTGGCNN	JUN
CATCAATGTANN	RELB
CACGGGCAGCTN	CTRL
TAGGACGCCTTT	EGR4
CGTCAGTCACNN	CTRL
GTGTTTTAACNN	CTRL
AACCGACGTTNN	TUBB
TCCAATTCAANN	JUND
ATACTCACTGTN	TUBB
GGGCATGTGTGA	REL
AAGCGCAGCNNN	CTRL
TACTGTCTCCCN	CTRL
GATTTATGGGGN	NFKB1
CATAACTCATNN	NFATC1
CTGCACTGATAT	RELB
GCAGCGCTAGAA	PTPN6
GCTTCGTCCGTN	MVD
GCTTCGTCCGGT	MVD
TAGCGGCCTTCN	BACH2
GTTTATCACGAA	NFATC1
TAGCGGCCTTGC	BACH2
GAGTTGGGTGGN	DHODH
GCTTCGTCGGTN	EGR1
ACGCGCCCTCGC	PTPN6
GCTCGGGGACNN	NFKB1
GACGTTAATTAN	DOK2
ACCTCGATTTCN	NFKB1
AATTGTTGTGNN	CTRL
AGGCATTTGCCC	NFKB1
AACTTAGTTNNN	EGR3
CTTATTGGCNNN	JUN
TCCATATACTNN	ZAP70
TACATCCACCCN	PTPN11
CGACGTTCCCNN	ZAP70
CATTACTTCGAN	NFKB2
ACTTCAACCNNN	NR4A1
GCATACGCGANN	EGR1
TACTACCCTACA	ZAP70
AAGTCCAGCNNN	NFATC3
TCTTGCACCNNN	RUNX1
GCCTCGTAGTNN	CTRL
TGCTAACTTTAN	NFKB1
CCTGTATGAGAN	NFAT5
CGCGTCCGGGNN	PTPN11
TACCGTTCATNN	JUNB
TGCAACTGNNNN	CTRL
GACTCTAATCCN	CTRL
GATTCACGATNN	NFKB1
CGTCCTACCTGN	EGR1
GTTCACGATNNN	NFKB1
CAATCACTGGTG	EGR3
TCCTTCTCTANN	CTRL
CTCTGCACACNN	DOK2
CTTTCCTGACCT	NFKB1
TCAAGGATGCAT	RUNX2
CCTTAAAAANNN	NFATC1
CTCAGACTTGGN	CTRL
CACGTGAATGNN	PTPN11
GTACGCCTAGCN	RUNX1
GCAAACCTCGCC	RUNX2
TATCAATCGNNN	EGR2
CTGAATTCGGCN	NFAT5
CGAGTGGAGNNN	REL
CGACAGTCAATN	ZAP70
AATATCTGAACN	RUNX2
ATCCGCCCTTAN	BACH2
AACAGTCGTTGC	NFKB2
CAGGGGAGAACN	NFKB1
GTGAGAATTAAT	RUNX2
CTCAGTCACNNN	CTRL
CCCTTGGTACNN	BACH2
TCCTCCTCCTGT	JUNB
CGGTCCACCTTT	CTRL
ACGTATATCAAG	JUNB
CTTTAAAGCGAN	NFKB2
CCAGTTACTTGN	ETS1
TCAAGGATTANN	CTRL
GAGCTTAACTCG	NR4A1
GAAATAGCCANN	EGR1
GCGAATCTGTCA	EGR2
GAGAAGCATCTN	EGR1
GTTAGAGCGTNN	FOS
CTGGAGACTTTC	CTRL
ACAGGTTTCCCT	NR4A1
CCGCCTTATGGN	JUNB
GCAGCTAGAANN	PTPN6
CGGGAGTGGAGN	REL
ATCCACGCATNN	EGR1
CTAATTGGCNNN	GATA3
TAGCGGACGGNN	JUN
CCAGAATATGAN	JUN
CTCCTACCTNNN	EGR1
GCTGCGGGGACN	NFKB1
TAACGACGAACN	CTRL
GCCCAGTGTANN	NFKB2
CCTTCGGCTCNN	NFAT5
GTGCCTAACTTG	EGR4
TCCGGGTAAGTN	CTRL
CAATAATGNNNN	NFATC1
GTCTAGATGTCN	CTRL
CAGTTCATCCNN	RUNX2
AATAGGACGCNN	EGR1
CTCACACCTCAG	NFKB1
GACGTTACATTA	DOK2
AACTTGTTNNNN	EGR3
TTTGGCCTCACN	FOS
CTACCCGTGTGT	DOK2
GATAAGGACGGN	RUNX2
GCACCTCAGTTC	CTRL
CGCCCGGACCAC	GATA3
ATTCTCGTACAT	NFATC3
TAAGTATGCANN	PTPN11
GAAACCAATGNN	CTRL
TGACTGTCTCCC	CTRL
TTTCTGTTTTCN	JUN
TCTAAAAGGACN	CTRL
ATCATATTTCNN	CTRL
TATTGCCTGTCA	RELB
GTCTAATTCNNN	CTRL
CAATAAGTGNNN	NFATC1
GAGCCCTGTGCT	BACH2
TCTCCCCGCAAN	JUND
GTCTAGATTCNN	CTRL
GAGTCCCGANNN	ZAP70
GACCGCCAGCCN	ZAP70
TAGGAGAGTTAN	CTRL
ACTCGCTAAAAN	CTRL
AACTGTTGAGAN	NFATC1
AGTCGGTGAAAN	PTPN6
GTCTTAGATGTC	CTRL
CTACCCGTTGTN	DOK2
GTCTTAGATTCN	CTRL
CATTACCCTATN	PTPN11
AAAACTTACGCN	EGR1
GCTTCAAATCAA	REL
AGCCTCGTGAGT	CTRL
AGATATGAGNNN	REL
CCTCGTCGGCTN	JUND
CCACTCCCTTGN	NR4A1
ATCGTACAAATN	RELA
TTTGTCCCTANN	DOK2
AGAAATAGCCAN	EGR1
CCTGTAAGGCNN	RELA
AACTTTAGANNN	NFATC1
CGTGCCTACCTG	EGR1
GTTTATCCGAAN	NFATC1
GCCACTCAGTGN	NFKB1
GTAATTGCGAGC	JUND
GTAATTGCGACN	JUND
GCTACGCGANNN	EGR1
GTCATCGGGNNN	CTRL
GGATATACACCC	NFKB1
CCCTTCCTGAAN	CTRL
GGATATACCCCN	NFKB1
CTAACGGTCTCN	CTRL
CTAACGGTCTCA	CTRL
ATTCCCTGTTNN	CTRL
TCGCCGCAGAAC	CTRL
TTGATGGTTTGN	PTPN6
TTGATGGTTTNN	PTPN6
GGTTTATCGGNN	JUNB
CCTCGCGGCTNN	JUND
ACCTCAACAGAT	NR4A1
CAGTATTCATCT	ZAP70
CTCTTCTGTTGN	CTRL
CTCTTCTGTGTG	CTRL
ACTCTCCCGAAN	NFATC1
TATTGCCCCATN	REL
ACTTCAGACCNN	NR4A1
GTCAGTCGAANN	NFKB1
ATAACCGTCANN	NFAT5
TGAGCACAAAAN	EGR4
TCGGGGGCCGCG	NFATC3
TGAACGACGAAC	EGR1
CGGCCACCTTTN	CTRL
TTATGGCAATCN	CTRL
TTATATTTTGCN	FOS
TTATATTTTCCN	FOS
TTATATTTTCGC	FOS
GCACCTCTTCNN	CTRL
CTTACCCTATNN	PTPN11
CCGAGTGGAACN	EGR2
GCATGACCACNN	DOK2
TCACAGTACCNN	CTRL
TCCCTGACTGAC	CTRL
GTCACTCGTAAG	CTRL
CCGGATCGCCNN	NFATC1
CTTGATAGANNN	JUNB
TTACAGGACAAN	REL
CAATAAAGTGNN	NFATC1
CAATTGTGGCNN	JUNB
TTCTTGCACCNN	RUNX1
CGTCCTTGCANN	REL
CGTCCTTGCCAN	REL
AATGGGACAATN	CTRL
CTAAGTACAAAN	EGR1
TTCTTGCACGCN	RUNX1
ACTCTTTGGGNN	JUNB
TGTATAACNNNN	REL
CCATTGTTGTAN	CTRL
TGTCCCCGGCAN	NFATC1
CTATGTTCCGTT	JUND
GGACAATGTTCN	CTRL
CTCGGGACNNNN	CTRL
CTCTTCGTTCCC	PTPN6
TACTAAAAGGAC	CTRL
CGCCGCCACNNN	GATA3
CGGATGCGTACN	REL
TTAAGTAGACCC	NFKB1
GGCAACTATTCN	EGR1
GCAGACTTTCCC	RELA
TTCTTCAATACN	NFKB1
CAGATTCATCCN	RUNX2
CTTCAGACCNNN	NR4A1
CGGATGGTACNN	CTRL
CATACATGGTNN	DOK2
CGCCCGGCCACN	NFKB1
TATACACTGNNN	REL
TATACACTGGNN	REL
TTCTTCATACNN	NFKB1
GCGGTCGGGTTC	CTRL
GCGGCCTCATNN	NFATC1
CCGGAGTTCTTA	CTRL
TCCAGTTATTNN	RELA
AGCGGTTTACTN	GATA3
CACCTCAGTTCN	CTRL
TCGCGCGGATGN	CTRL
GGCGGGAAATCG	NFATC1
GGTCGTTTTAAC	CTRL
ATCCTTCTTCTA	CTRL
CGTCGTCGTCTN	FOS
AGGTTATTTTAN	NFATC2
TGGACGCTACNN	RELB
CTATCGGTAGTN	CTRL
ATCAGTTTAGNN	BACH2
TCCCACTTTGNN	NFAT5
TCACATTGTANN	PTPN6
TCACATTGTACN	PTPN6
ATACAGTTGCAA	LCK
CTCACTGGTGTN	NFATC1
ACATGGGCAATN	CTRL
CCATTTAGCNNN	CTRL
TCCGTACCCTAA	DHODH
CACGGATCGCCN	NFATC1
TTTCTTCATACN	NFKB1
GCGGTCGGTTCN	CTRL
GCTCCTACACAT	FOS
GCTCCTACACAN	FOS
TCTGAGCTGGTA	CTRL
CAGTTACTTGNN	ETS1
GTAGAGCGGCTN	CTRL
TTCTCGTACATN	NFATC3
CCCTTCCCTGAA	CTRL
GCAGCTAAANNN	PTPN6
GTCCTTGCGAAN	NFKB2
CTTTTCTTTCAN	FOS
TCTCAGATCACN	CTRL
CGGAGTGGAGNN	REL
CGCTCGGCACCN	DOK2
AACCGGACGTTN	TUBB
TACGTCTCCCNN	CTRL
GATAGGACGGNN	RUNX2
GGCGGGAATCGN	NFATC1
TACCATCCCTTN	NFKB1
TCTCAATATCNN	DOK2
CTACATTACTAT	JUNB
ACAATACAATTT	NFATC1
ACGTCTTTGGGN	JUNB
GATAGGACGNNN	RUNX2
GGACAGTATCCN	BACH2
TCCAACTCTGGN	LAT
CATCTTCGCGCN	NFATC3
TCCGTTCTGCNN	DOK2
TCCGTACCTAAN	DHODH
ACGTTTCCGATN	RELB
ACGTTTCCGATG	RELB
TCCAACATTGGN	PTPN6
TGCTAGAGAGAG	JUNB
GTATTGGGTGGN	DHODH
ATCTCCCGAANN	NFATC1
CCCCGTCGTCGA	CTRL
GGCACAGGATGN	NFKB1
GCCAGTTCCGTG	CTRL
ATCATTATTTCN	NR4A1
ATCATTATTTCG	NR4A1
TCCCCCGTCTGN	JUNB
TCCCCCGTCTNN	JUNB
AAGAGGCCGCTT	CTRL
GTCGCGCTAGAN	CTRL
AACAGTCTTGCN	NFKB2
CTTGCACGGNNN	JUN
GAGGCCGCTGTA	NFKB1
CCCAGTGTTNNN	JUND
TTCTATAATGCT	BACH2
CATCACTGGTNN	EGR3
TTATGGCCACNN	NFAT5
ATCGTAGGATAC	CTRL
AGTCCGTAGGNN	NR4A1
AAGTAGGACGCN	EGR1
TATTGGATCGCG	GATA3
CTAGAATTCGGC	NFAT5
ATACGCGCCTGC	CTRL
GCGTGCACCGTG	BACH2
GCGTGCACCTGN	BACH2
CCCTAAACCCCG	NFATC2
TTCTTCACGCTN	CTRL
CGCCGGCACCNN	DOK2
GATACAGGCACN	CTRL
TTCTTGCCCNNN	RUNX2
GCACAACTCTTT	JUNB
GAAACACCAGCA	DOK2
CCCTGTTGCCTA	NFKB1
AACTGTTAGANN	NFATC1
AGTCGTGAAANN	PTPN6
CTCGGGGACNNN	CTRL
TTCTTGCCGCNN	RUNX1
CAGCACAAGAGN	CTRL
TTCTATATGCTN	BACH2
TCCGCTCTCNNN	PTPN6
CCATTACTTCGA	NFKB2
TCCTGTCTGTAN	NFATC2
GGCAAGCTCGTN	JUNB
TAACGGTCTCNN	CTRL
TAAGTACTAACN	CTRL
CCCGTGTTTTGN	CTRL
AGATGACGATAG	CTRL
CAAACAGTTTAC	RELB
AACAGTCCCTCT	EGR4
CCTATCAGACNN	NFKB1
CACTCTATTCTT	CTRL
TGAAGTATGCAN	FOS
ACCACCCCTAAN	JUN
ACCACCCCTAAG	JUN
ACCACCCCTANN	JUN
TACTGAGCGTCC	NR4A1
GGACGTATCCNN	BACH2
TTTATTTCTGGN	CTRL
GTCATCTGCATN	BACH2
CCCAGTAGTTNN	JUND
GAGCTAGCANNN	ETS1
TAGCAGACTCCN	CTRL
TAGCAGACTCCA	CTRL
GCGTCATTCTNN	RELB
ATGGACGCTACN	RELB
AGAAATCCGNNN	GATA3
CCGAGGCAAANN	ZAP70
GCATTAGAACAG	DOK2
GAAGACCAATGN	CTRL
GATCACCCGAGN	JUNB
CTTCAGGACCNN	NR4A1
GCTCAAATCAAN	REL
TGGCAGGTCTTG	CTRL
TAATACTAACNN	CTRL
GTATGACTTGTN	NFATC2
CTTATACTAGNN	CTRL
GCCCGTTCTGAT	NFKB2
TTACCATCCCTT	NFKB1
TCTAAAGGACNN	CTRL
TCCATTACTNNN	ZAP70
AATGAATAGGGC	EGR1
ATACTCCTGTNN	TUBB
CCTGTAATCAAT	CTRL
GGCTTAGGTGCN	EGR2
GCACGCTAGAAN	PTPN6
ACCTAACCTANN	ZAP70
ACCTAACCTGAN	ZAP70
CTAAGCCCTTAN	BACH2
TATCATCGAANN	EGR2
CTGGAGCACGAN	CTRL
TTATAATGGATN	CTRL
CAACACCGTTCG	JUND
GTGAATCCTCNN	CTRL
TTCTGCACCNNN	RUNX1
AAGATAGGACGC	NFKB1
CTACATCCACCN	PTPN11
CTACATCCACCC	PTPN11
CTCTTCTTGTGN	CTRL
AGATTAGCCTTT	NFKB1
CTAATATAGNNN	FOS
CGTTATACTAGN	CTRL
CGCTGCTCATNN	RELA
GCCTCGTGAGTN	CTRL
CGAGAGTGGAGN	REL
GCCTCGTGATNN	CTRL
CCGCACGTAATC	DOK2
CAAACGTTAGTN	NFKB1
CCGCACGTATCN	DOK2
GTCTTTTAACNN	CTRL
TATTCGACTCTN	NFATC2
GGCAGTATCCNN	BACH2
CTAGCCCTTANN	BACH2
GTTCGTCCGGTN	MVD
CATGTTCGTTNN	JUND
ACAGTGCCAAGN	NFAT5
TTGGAATCCTNN	NFKB1
TTGGAATCCGTN	NFKB1
GACTCTGCGGNN	RUNX2
TTGAATCCTCNN	NFKB1
ACTCTCCGAANN	NFATC1
CCGAGGCTACAC	JUN
TCGGGGCCTTTC	PTPN6
GTTAAGTCGAGC	CTRL
CTATCGTAGATN	CTRL
GCATCAGAATNN	CTRL
CTCTTCTTTNNN	CTRL
CTCTTCTTTGNN	CTRL
CAATTCATCCNN	RUNX2
CGCTGCATCATN	RELA
CGTTTCCGATGN	RELB
TATTCTCTGTGT	FOS
ACAATTCATCCN	RUNX2
AGAGACGATAGN	CTRL
GCGCACTCAGTN	NFKB1
GCGCACTCAGTG	NFKB1
TTGCCCTCTTTG	PTPN11
GCTAGCTCTCTN	EGR4
CGGAGAGTGGAG	REL
GCAGGGGTTCGN	NFAT5
GAAAATGTGCAN	NFATC1
GCGCACTCGTGN	NFKB1
GTATACCCGCAT	NR4A1
CGCCGGCCACNN	GATA3
CGTCCACCTTTN	CTRL
CGCTGCATTCTN	EGR1
ACCAGCACGCNN	NFATC3
CTTAAGGCACGG	JUNB
CCATCAATATNN	CTRL
TCCCTCCTGTAA	NFKB2
CCATGACCCCNN	PTPN11
TCCGGGGAAAAN	NFATC3
AGTCTAAACANN	CTRL
CCATCAATANNN	CTRL
GGCCGGTGCNNN	CTRL
TTGGGCTTTTCN	NFAT5
ACCGATAAGGAN	NFKB1
GTTTGTTCCCCN	JUNB
GTTTGTTCCCNN	JUNB
ACGCAACCAGNN	EGR4
TCTAAAACTCCA	GATA3
GTGTCTGTAACC	CTRL
GACTTCGAACNN	JUNB
GGGCGTTAAGNN	DOK2
GGCCGGTGGCNN	CTRL
GACTTCGAACAN	JUNB
TAGAGGCTTGNN	FOS
TAGAGGCTTNNN	FOS
CTCATGCCCCNN	PTPN11
GTCCTTCCATNN	CTRL
TCGTGTTAGCNN	MVD
ATATCCCTANNN	NR4A1
GACTTCGACANN	JUNB
CAGGTGTGAACN	NFATC1
ACCAACCACGNN	EGR4
CCGGTCTCTACA	CTRL
CCGGTCTCTCAN	CTRL
CTCTATTTCANN	REL
ACCAACCACNNN	REL
ATATCCCTGANN	NR4A1
TATCACACANNN	RUNX1
TCTCAAACGGGA	LCK
CGGACGTATGNN	JUNB
CGGCTGTTANNN	NFATC3
TAGTCCTCCTCN	CTRL
TAGTCCTCCTCG	CTRL
CTAGCGCTCTTN	FOS
AGTAACTTCTAG	NR4A1
ACCAACCAGNNN	EGR4
GCACGCCCACTN	FOS
TCTCCGCTGCNN	NFAT5
GACGGACTCTTN	CTRL
TGCACGGTNNNN	CTRL
GACCGATCCTTG	REL
CATGTGCCGTNN	JUNB
GGTAATCCCCNN	EGR2
AATCTGCTTCTN	NR4A1
CTCGGCTTCTTC	CTRL
GCACCTCGGANN	JUND
ACAAACAACCNN	CTRL
GGTACGCTCGGN	LAT
GGTAATCCCNNN	EGR2
CAGTACGGTTNN	NFKB2
GTCCCCGTCTNN	BACH2
ATCCATCAGCNN	PTPN6
GAACGCGTTTAC	CTRL
ACTGTCCGCGNN	NFATC1
GCATCGCAAATN	NFKB1
CACAAGGAATNN	JUND
TCGGCCGAGACN	CTRL
AGTCCGGGTCGC	LAT
AGTCCGGGTCCN	LAT
GAGATAAACNNN	RELB
TTCTTTCTTATG	NFKB2
TATCACACNNNN	REL
AGGGGGCGCCAN	PTPN6
CGCAAAGTAGTN	NFKB1
TGACCCCTGCTN	NFATC3
TTCCCCTGTTNN	NFKB2
TAGTCCTCTCNN	CTRL
TCAGAAAATGAN	NFATC1
AGCCTGTCCTTC	GATA3
AGAAACTATTCN	CTRL
TCGGGCCGAGAC	CTRL
CCCAATCGTANN	RUNX2
AAGACGGACTAN	JUN
ATCCATCATNNN	RELA
TCAGAAATANNN	NFATC1
TCCATTCGTACN	DOK2
ACGTTCCCAAAN	JUND
CATGCATAACGN	EGR1
CCCTTCGTCGGN	GATA3
CCCTTCGTCGNN	GATA3
CTCGTTTGTTNN	JUNB
AAGTTTCCCCAN	JUND
TCTGCGCATAAN	NFATC3
CCCCCCGTCCGN	CTRL
TGGTTAGGCNNN	PTPN11
GCGTCTAATAGT	CTRL
CTTGACCAANNN	EGR1
CGCACCCGGAGA	NFATC2
GCCGCGGCACGN	CTRL
CCGTCGTTTTCN	FOS
GGTTTGTTCCCC	JUNB
GGTTTGTTCCCN	JUNB
GAAGACTCTCCN	NFATC3
GGCATTGACCAC	JUND
GTAACACGAANN	NFATC2
TCAGTTTGGTGN	BACH2
CTTACATCTCGC	CTRL
ACGACGTTGNNN	RUNX2
GTATCTATTANN	NFKB1
ACCATAGGANNN	NFKB1
GCGTCTATAGTN	CTRL
ATGGGATCTTGN	BACH2
AACAAATCTCTT	CTRL
CACGGCTTTCGN	EGR2
TTTCAAAACCCA	CTRL
TGCGTCCAATNN	EGR2
ACATGATTTTTG	NFATC2
ACATGATTTTTN	NFATC2
TCTCCGTCAGGN	JUN
GGTTCCCCGCGN	NFATC1
TGCGGCGCAACN	PTPN6
CCATCTATCGNN	CTRL
TGCGGCGCAGAC	PTPN6
CCCCATCGTGTA	NR4A1
CGCAGCTGCCCN	NFKB2
CTCATGACCCCN	PTPN11
ACATTTCTTATG	BACH2
CGGGACGTATGN	JUNB
ACATCTCATANN	ZAP70
ACGCAAACCAGN	EGR4
ACGCAAACCACG	EGR4
CGTATCCATANN	LCK
GAACAGTCTGAA	CTRL
CAGCCCCTACGN	CTRL
CTCTTATAGCGN	JUNB
CTCCGCACCCTN	CTRL
CTGTAGGGTACN	NFKB2
CTCCGCACCCGT	CTRL
GCAACGATGCAA	CTRL
CGGTATCCATAN	LCK
CCCTGTTTANNN	NFATC1
TATGCTATTNNN	RELB
CACCCCACAANN	NR4A1
TCGCGCAGTCCN	CTRL
AGTCTAACANNN	CTRL
TGAAGCATAGNN	EGR1
TGAAGCATAGGN	EGR1
TGAAGCATAGGG	EGR1
TTCTAGCTCCAT	NFATC1
GCAAACTACACN	CTRL
GCACCGCCGACT	GATA3
GCACCGTCCGNN	NFATC3
CGAGGTCTACTN	CTRL
AACAGTGAACCN	RELB
TCGCAACATTNN	CTRL
AGGGCTACTNNN	NFKB1
ATCTGCTTCTNN	NR4A1
TGGGCCGAGACN	CTRL
GGACCCTCTGCN	ZAP70
TGATGGGCTAAN	NFATC3
CCCTGCCGTANN	CTRL
GTTCCCAAANNN	JUND
TGTTAAACATCN	CTRL
CTACTCCGTACN	LAT
AACTAATCATNN	NFAT5
GCAGGAGCCTCC	JUN
CCCTGTCTTAGN	EGR2
CCCCCGGAGANN	NFATC2
TAAATCCTTANN	FOS
ACTTCAACCCGN	PTPN6
CATGACCATGTN	RUNX2
GGCCTCTCGNNN	RUNX2
CAATAGAGATCC	FOS
AAATATCCCTAN	NR4A1
CGGTATCCTANN	RUNX1
AGTCCTAAATGN	RUNX2
GAGACTCTCCNN	NFATC3
ATAACACTACNN	JUN
GCTCTCGAGGTN	LCK
CATCACCCAAGN	NFATC3
CATCACCCAANN	NFATC3
GCCTCAAGCTTG	NFKB2
AGGTAATCCCCN	EGR2
AGGTAATCCCNN	EGR2
TCCGCAGTCCNN	CTRL
GACATCCATANN	ZAP70
GCCGCGCACGNN	CTRL
ACAAACACCNNN	CTRL
GCCCGGTTATAC	CTRL
CCAGGTCCTAAN	JUND
GGGATGGCATTN	NFATC1
TGAGGGGCTAAN	NFATC3
GCATGGAAAGGN	NR4A1
CCCCTGGTTANN	REL
TGCTATCAGGNN	REL
CTACGTCATAGN	NFKB1
GCATCGCCAAAT	NFKB1
GCATCGCCAATN	NFKB1
AATAACTATTCN	NFATC1
GAAGGCAGTCAN	JUND
CCTGTCCTGANN	JUNB
CATCACTCCAAG	NFATC3
CATCACTCCAAN	NFATC3
GCCCCTGTNNNN	LCK
TACGACATCNNN	RELB
AGAGGGGGCCAN	DOK2
TCTTGATAGGAT	EGR1
TCTTGATAGATN	EGR1
TTACCCCTATAG	RUNX1
TCCCATTCGTAC	DOK2
ATTTCGCCTATN	NFAT5
TACATCCATANN	ZAP70
TACGACTCNNNN	RELB
ATCGGATGTAAN	REL
ATTTGGTCGGCC	CTRL
CATTGACCAANN	EGR1
TGCAGCCCCGNN	LCK
CATTACTTTATN	ZAP70
TTTAGCTCCATN	NFATC1
TAACCAGACTCN	NFATC1
TACCGCGCCANN	PTPN6
CTACGTCTAGNN	NFKB1
TACCGCGCCNNN	PTPN11
CCGATTCCCAGN	FOS
CACGGTGTGAAC	ZAP70
CGGCCGTCTCGN	RELB
CGCTGTCTCAAC	JUND
TCCCAGTGATCN	DHODH
TGCAGCCCGCGN	DOK2
TAATAGGGAATN	CTRL
CTACTTCCGACN	CTRL
CTACTTCCGAGC	CTRL
CTTTATGAGACN	NFATC1
GAATTAGATGCC	NFATC3
ATCGCGCAGTCC	CTRL
TTTAATTCCNNN	CTRL
CCACAACCAGCG	CTRL
CCTCCGCACANN	RUNX2
ACTTCCGCGGNN	NFATC1
ACATGTTTTTGN	NFATC2
ACATGTTTTTNN	NFATC2
ACTTCCGCGNNN	NFATC1
CATTCTTTATNN	ZAP70
GTTGGCCTGANN	JUND
TCCCAGTGGATC	DHODH
CTATGACCAANN	EGR1
AATCGATTGCNN	CTRL
CTAACTCCGTAC	LAT
CGCAAATAAATN	ZAP70
CAGGAATCANNN	EGR1
TCCTTCACAGNN	PTPN11
GTTATACATATN	EGR1
TCTATAACCANN	CTRL
ATTGACTACCCN	EGR4
GTCGTCTACCCN	CTRL
GCGATGTTCCAC	CTRL
CCCCTGGCGGCG	EGR3
TCGAATTTCTGA	JUND
TCAAGAAAATAN	NFATC1
CTTAGGTGGTNN	NFATC2
CTTAGGTGGTGN	NFATC2
TGCCCGCATTAN	PTPN6
GTTAATGGGGCN	CTRL
TACCAACTCNNN	NFATC1
CTTCCGCGGNNN	NFATC1
CCCTGGCGGCGN	EGR3
TTGTTCGTCCNN	RUNX2
TTCTAGATCGCN	RELA
ACAGACGGAANN	EGR2
TTCCCCTAGTTN	NFKB2
GGGACCCTCTGC	EGR1
AGGGATCTTGNN	BACH2
TAAGAATTGCTN	DOK2
GCACCACCACTC	CTRL
CTAGACTTTGAC	RUNX2
ATAACAAATANN	DOK2
TATCGGTACGGN	FOS
CCTGTCTCAANN	JUND
CCTGTCTCAACN	JUND
GTGTTTCCGNNN	NR4A1
ACCCATGTCAAN	NFAT5
GCCCCTAGTNNN	LCK
GCACCACCCTCN	CTRL
TTCCCGGCCATA	EGR3
TATTACTGGANN	EGR1
GCGACTCGGNNN	ZAP70
CTTGGTCTTCTA	CTRL
GAACGCTTTACN	CTRL
TCTAGTCTTGTT	NFKB2
CCTCCGCTCCTT	NFAT5
TCCCGGCCATAN	EGR3
TGTGCCACGTNN	CTRL
GCAGGTGCGTNN	CTRL
TGTGCCACGTAN	CTRL
TCTCGTTATANN	BACH2
AATCGGACGCTN	EGR3
ACGGCTGTTANN	NFATC3
ACACTACGANNN	EGR1
TCAAGAAATANN	NFATC1
CCGTCTCTACAN	NFKB2
TGAGGGCTAANN	NFATC3
ACCTCCTGTGAN	RELB
TGGCCGAGACNN	CTRL
TCAACTTTACCC	RUNX1
TGCCCGTTGCTN	DOK2
GAGCACTCTCNN	JUND
GCAGCATTCATN	NFKB1
CCTCTCACCGGN	RELA
CCTCTCACCGNN	RELA
GCCAAATGGTNN	CTRL
TCAACTTTCCCN	RUNX1
CAGGACCGTGTC	CTRL
GCAACTCTTACN	JUND
AGTCCGGTCCNN	LAT
GCAGCGATTNNN	EGR1
CCCAATCTANNN	RUNX2
GCTCAGCTCTAA	CTRL
CACCCCGACTNN	GATA3
CTGCCGCCCAAC	RELB
CCACCCTCACCN	CTRL
GATATACTGNNN	CTRL
TACTTGGCCAGA	RELA
GTCGTCTTCGAT	NFATC1
CGATTGAGTTNN	JUNB
GTGACGGTCCGN	BACH2
GTGACGGTCCNN	BACH2
CTACAGAAGGGN	DOK2
AACGCCGGATTN	BACH2
ATCCCGGGACTT	FOS
CATATCTATCCA	RELB
GTTGCCATGANN	JUND
CTCTCACCGGNN	RELA
CGGCTTTTTCTN	ETS1
CCGCTCAGTCNN	CTRL
TTTAGCACGCNN	EGR3
TCTAAAGCTTCN	RUNX2
TTTTATAATCNN	RELB
TGCCCGTTTGCT	DOK2
GTCACCTCGACT	CTRL
GTCACCTCGCTN	CTRL
TGTCTCGATANN	CTRL
TCTGCACCGACC	CTRL
TCTGTAATTCCN	CTRL
CCGGCTTTCGNN	EGR2
CAAGGAATCANN	EGR1
CACCGCCGACTN	GATA3
CTGAGGTCTACT	CTRL
CATGTTGGGTGC	CTRL
CCTTGCATAGCT	EGR3
GCGCATTCATNN	NFKB1
GGATTGACCACN	JUND
ACCCAGCCGCCA	EGR3
AGCCGTCTTTTC	LCK
GACTTCAACANN	JUNB
TTACTATAATCN	RELB
TCGTATTTAGNN	RUNX2
CCATTTCGTAGN	EGR1
ATCCTAAATGNN	RUNX2
GGATATACTGNN	CTRL
TACCAGACTCNN	NFATC1
CCACCCGGAGAN	NFATC2
GCTTCTAAGGTA	RUNX2
TGTTAATGGGGC	CTRL
TTGCTTACGGTN	JUN
CCATTTGTCATA	PTPN11
CCATTTGTCACC	NFAT5
TCGAACGCATTC	JUNB
TGAGCATAGNNN	EGR1
TGAGCATAGGNN	EGR1
TGTCCAATGNNN	PTPN6
AGGGAGTGGGTN	NFATC3
CTAATAGATAAN	LCK
AGGGCCGGTGGC	CTRL
CATGTTGGTGCN	CTRL
CGGGTTTTCGTN	PTPN6
CGGGTTTTCGGT	PTPN6
AGGGATGGCATT	NFATC1
GGGACGCATCAG	NFATC2
CAATTTATTTAN	PTPN11
AATCACTCTANN	DOK2
GTCACCATTGTN	NFATC1
CGCGGTCCTAAN	JUND
AAGATACACTGN	CTRL
CCCGTATGTTNN	EGR1
GCGGCGCAGACN	PTPN6
CGTGACTGACGG	PTPN11
ATCCTAATGNNN	RUNX2
TTTAAACGATCN	CTRL
ATTGTAACCCNN	JUND
CTGACTTACCNN	JUN
TAATTCATTGTT	CTRL
AAGGGGGCGCCA	PTPN6
AAACGCCGATTN	BACH2
GCAGCCCGAACT	CTRL
TCTCCCAGGCNN	REL
CCGGTGGAGANN	EGR1
ACAGTACGGTTN	NFKB2
GCCCTCTGTNNN	LCK
AGTTCCCAAANN	JUND
TCATGAAATACA	CTRL
CTCTCCGTCAGG	JUN
CCGGTGTGAACN	ZAP70
ACGAACCCTGNN	EGR2
CGAAACGTTTNN	CTRL
CACCCTCCACCN	CTRL
TCCGTATTTAGN	RUNX2
TAAACATAACNN	CTRL
TCCGTTCACAGN	PTPN11
CTACTCCTACNN	LAT
TTTCGGATCCCA	JUN
GCCGGGTCTCAN	NFAT5
CGGCAAAGTAGT	NFKB1
TGTTTTCTTCAN	EGR2
CGGCAGCTGCCC	NFKB2
GTCCATTCCATN	CTRL
GTCGGCTTGTTN	CTRL
CTTCAACCCGNN	CTRL
ATAACAACTACN	JUN
TGAAACTCACGA	EGR1
TGAAACTCACGN	EGR1
AAGCTTGTTGGN	MVD
AATACTATTCNN	NFATC1
GGCCAAGACANN	LAT
CCCCCCTCCNNN	CTRL
TCCTTCGACAGN	PTPN11
TCGAACGCTTCN	JUNB
ATCAACTCAGNN	PTPN6
CGGGCCGAGACN	CTRL
AACACTCTANNN	DOK2
TTCGTTGACGNN	NFATC3
GATCCATTCCAT	CTRL
CTAAGCCATCNN	RUNX2
TCGGATAAANNN	CTRL
GTCTTTGTGCTN	PTPN6
GAGGGCGTTAAG	DOK2
ACCAAACCACGN	EGR4
CCCATGTCAANN	NFAT5
CTCTCAACCTNN	LCK
AAACGCCGTTNN	BACH2
TCTAAGGGAAGN	NFATC3
GCCAGCTGTACN	EGR2
TGGTTGTAGTAG	REL
CACTCTAACNNN	CTRL
CGGTTTTCGTNN	PTPN6
CTAGAATACTGN	NFKB2
CGGTTTTCGGTN	PTPN6
TACAATATATGN	CTRL
AATAACACTACN	JUN
ACCGATAGGANN	NFKB1
GACTTCGGAACA	JUNB
AATTGTAAACCC	JUND
ATCTGACTTAAN	RELA
TCCCCACCTGTN	REL
CTTCATCTCGCN	CTRL
TGGTATCTCTAA	CTRL
AATTGTAACCCN	JUND
CACCCGGAGANN	NFATC2
GTGGATGCAACG	REL
TGAGCACTTCTN	JUND
TGAGCACTTCTC	JUND
GGGCCCTCTCNN	ZAP70
CAACTCTTACNN	JUND
TTACCGATGATG	ZAP70
CCTTCGTCGGNN	GATA3
TAACGTGTTAGC	EGR4
GAAAGACTCTCC	NFATC3
GCCCGTTTGAAN	JUN
TACGGCCTGGAT	PTPN11
GAATTGATGCCN	NFATC3
ATTTTGGTGCTN	CTRL
ATGTCTGTCTTC	RELA
ACGGCGACTNNN	NFATC3
CTCTAGTTTCAN	CTRL
GACCTGTCAAAN	CTRL
CTCTAGTTTCNN	REL
CCGTTCCAGNNN	JUNB
ACCATAAGGANN	NFKB1
ATCCATCGATNN	RELA
GTCGCTCGGNNN	LAT
ATAGCAGGGAAN	NR4A1
ATAGCAGGGACA	NR4A1
AAGGCCAATCNN	EGR1
GATTACCAGAGN	FOS
GGTGTTTCCGNN	NR4A1
AGCATAGATTAA	NFATC3
TCTGGTCCCGCN	FOS
GGGCAGGACATG	NFATC1
CCCGTGCTAAAN	NFKB1
TCAGGTTTGGTG	BACH2
CTTTGCTATAGA	NFATC1
CTTTGCTATAAN	NFATC1
CAGACTTTACNN	RUNX2
CGGGACATCCTN	PTPN6
GCTCGCCAAATN	NFKB1
ACAGGACGGAAN	EGR2
TGAACTCCGANN	EGR1
TATCTATCGCNN	DOK2
GTTCCCCGCGNN	NFATC1
AGTTTCCCCANN	JUND
GACGCCTCACTN	FOS
GCGCTGACCTTA	NFAT5
TTCTATAATCNN	RELB
GACCTGATCAAA	CTRL
CAGACTTTGACN	RUNX2
CTGATTATCTNN	CTRL
AGTGATTAGTAN	NFKB1
ACTTTGAAGAAN	FOS
GTAGAGGTGTAN	PTPN11
AGCTTTACGCTN	NFATC1
TTCTATTCCGNN	NR4A1
CGCACAGCCCTT	LAT
CCCCGCATTTAA	EGR2
TACGTGTTAGCN	MVD
AATCTAGACCTA	CTRL
GACTTCACANNN	JUNB
ACCCACCGCACN	GATA3
CCGATTCGCCAG	FOS
TCCTGGACTCGG	PTPN6
TCCTGGACTCGN	PTPN6
GCAGCTTCGGNN	FOS
TTGATGTATACN	EGR1
TATTGGTCNNNN	REL
TTGCCCCTGTAA	JUN
GTATTTTACANN	PTPN11
TGGCAGCGATTN	EGR1
CCAGTGCCTTTN	JUNB
TAACTTTACTCT	NFATC1
GGCAGCGATTNN	EGR1
CGCTAAATAATN	ZAP70
CGCTAAATAAAT	ZAP70
CGATGCATAACG	EGR1
ATATCTATCGCN	DOK2
TGGCAGCGGATT	EGR1
GGGAGTAGGGTN	NFATC3
GCCGGTTATACN	CTRL
GCACAGGGCGNN	NFKB1
CTCGCTTCTTCN	CTRL
ACAATATATGNN	CTRL
GATAGCTGGGAN	NFKB1
GATAGCTGGANN	NFKB1
TTACCAAACCTN	CTRL
GGCTTATCTCGN	REL
GGCTTTTTGGNN	RUNX2
GGCCGTCTCGNN	RELB
GAATGTGCACAT	CTRL
CGCTATCTGGNN	RELB
TCATCGCGGGTN	BACH2
TTTGAACGATTN	NFKB1
GAAGCATAGGGN	EGR1
GAAGCATAGGNN	EGR1
GACAGGATCTTN	CTRL
GCACAGGGGCGN	NFKB1
GAGCACGACTTT	EGR1
TAGAGCTTGNNN	FOS
TGCGTATCAGGN	REL
CCGGTCCTAANN	JUND
CCCCGCACANNN	RUNX2
ACATCCATANNN	ZAP70
CCTGGACTCGGN	PTPN6
TCAGCTATAGCA	CTRL
GGATAGCTGGGA	NFKB1
TACTTATAACGN	REL
ATACAGGGACAN	NR4A1
CCATCGTCTACN	BACH2
CTGGTAGGGTAC	NFKB2
CTTCATTCGCNN	CTRL
TACCCACAGTAN	RUNX2
AATGAGCCCACC	NFKB1
CGAAGTAGTCNN	REL
GGTGACGGTCCG	BACH2
GATCTAACGCTG	BACH2
ATCCCGGACTTN	FOS
CTTTATTTTCTT	CTRL
CGTCACCATTGT	NFATC1
CACGAGCCAATN	EGR3
GCAGGGTGCGTN	CTRL
GTGTTTCGCGNN	NR4A1
GACCTGACAAAN	CTRL
TCCAGTATTTAG	RUNX2
ACGTACGGTTNN	NFKB2
AGAGGGGCCANN	DOK2
ATTTTGGCTGCT	CTRL
GTGCCAAGGACA	LAT
GTAATTATGGAC	REL
ATGAACAAATAN	DOK2
GCAAAATCGAGN	NFKB2
GCATAATTAANN	NFATC3
CTGTCAATTATG	GATA3
TTTACTATAATC	RELB
ACAGTGAACCNN	RELB
ACAAACCACCNN	CTRL
GATGGAAAGGNN	NR4A1
CATCGGCTATAN	NFATC2
TCAATCCCATCN	CTRL
GCCCTCTAGTNN	LCK
TGCTCTCTAGNN	NFKB1
GCATAGATTAAN	NFATC3
GTTGCCTGANNN	JUND
TGGGTTAGGCNN	PTPN11
AACGCCGATTNN	BACH2
GTATTTCTTCAN	EGR2
ATCCAGTCATNN	RELA
CAAACGTTCAGC	JUND
GTCCCTTAACNN	RUNX2
AATATCCCTANN	NR4A1
CTGTGCCGTNNN	JUNB
TAATCACTTANN	RELB
TTTGCAATACCG	PTPN11
TTTACGCGGGGC	MVD
TTTACGCGGGCN	MVD
TTAAGAATTCTN	DOK2
TCTGTCTTGTTN	NFKB2
TGTCTAGATCGC	RELA
GCGCGATCCGCN	FOS
GCACGCCTACTN	FOS
GTGATTAGTANN	NFKB1
AAATACACTGNN	CTRL
GCGAGCGATGCN	REL
AATATCCCTGAN	NR4A1
CGCCTGCCTCAN	PTPN11
GCACGCCTCACT	FOS
GCACGCCTCCTN	FOS
AAGCTAATGTAC	NFAT5
AATAGCTTTTCN	EGR1
CTGGACTCGGNN	PTPN6
AGGAGTGGGTNN	NFATC3
CCCCACCATTNN	REL
ATGAACAATANN	DOK2
CCCCACCATGTN	REL
CTTGACGTTNNN	LAT
CGATTACTTTAT	ZAP70
CGCAGGTCCTAA	JUND
CAATTGTATATN	EGR2
GACGGACAAATG	CTRL
TGGGTGATGTAT	NFATC3
GGTCCCTTAACN	RUNX2
GTTCAGCCAANN	PTPN11
TTCTCACTGNNN	CTRL
CTACGCTCTTNN	FOS
GGGACATCCTNN	PTPN6
GGCGACTCGGNN	ZAP70
CAATTGTTATNN	CTRL
ACCCACGCACNN	GATA3
CCTAATAGATAA	LCK
GCAACCTCCTCN	CTRL
CGCTATCCTGGN	RELB
GCAACCTCCCTC	CTRL
TTGAGGCTTTTC	NFAT5
TATTACTCANNN	EGR1
AAGTGATTAGTA	NFKB1
CTCATGAACCCC	PTPN11
CGGGGTACCCTT	NFAT5
GGTCTCTCAATN	CTRL
AATAGCCCACCN	NFKB1
AATCTAGCCTAN	CTRL
TCTAAGGAAGNN	NFATC3
GACAGGACTCTT	CTRL
TATTACTCGGAN	EGR1
GGTCTCTCCATN	CTRL
GGTCTCTCCAAT	CTRL
TATTACTCGANN	EGR1
ATACAAATANNN	DOK2
TCATCCCATCNN	CTRL
TAACCTGACACA	NR4A1
AAGGCGATTCGA	CTRL
ATACCCGACGTT	JUN
GCCACACGTGCG	EGR1
CCTCAGAACTTG	BACH2
AGGGCGCTGCTT	JUND
ATTCCTTTTGAA	CTRL
CGCCGGCGTTTC	RUNX2
GTCCGCCTTNNN	EGR2
CGTGCAAACCTG	EGR1
TCGGTCTGCCAA	NFATC1
ACCAGACAGTTA	NFATC3
TCGAATAATATC	CTRL
GTGTGAGCAGNN	REL
TTGACACAGACG	PTPN6
GAAAGTGTCAAT	RELB
TGTGGGTCGGTA	NFATC3
ATACCCGAGTTN	JUN
TCCAACTTCTTG	DHODH
TTCCATCTCTAT	CTRL
TTTTCTTCATCT	RELA
AAAAATTTGGCC	NR4A1
AAATGCCACAGT	REL
GTTGGAGCCTTG	CTRL
GTTGATTCGATT	RELB
TGCCAGGATCAT	BACH2
AGCAAGCTTCGT	NFKB1
GTGATATTTGGC	JUNB
GCGCAAAGTGCG	NFKB1
TCAATGCTTGTC	EGR4
CTTTATAGGTTC	NR4A1
GTTCCGGTGCCG	NFATC2
GAAAGCATTTCC	CTRL
TTGAGCAGTAGC	EGR4
GCGGTTTTTATT	CTRL
CGTCATCGGGTC	CTRL
CTGGGTCCACAC	BACH2
GGTCTAGCCANN	NFKB1
TGGACCGAGTAG	EGR1
GCTAGGAAAGTA	JUN
TTCACAAGCTAG	RUNX2
AATCTCAGACCT	RELB
GCCTCGGTTCCC	GATA3
CAACTGATCAAC	CTRL
AAGGCACGCAGT	LCK
GACATCAGATAA	CTRL
GTCCCCCCCCAA	MVD
TTGTACGGCTTC	CTRL
GGCATCTTATTA	NFKB2
CCGGATCTTCCC	RELB
CTTAAGACGGAA	CTRL
GAGTTTTCTTCC	JUNB
CGGGTATCGTGT	REL
ACGCCACCCGGC	CTRL
TCGTCCTGATCA	CTRL
ATATAATCAACG	RUNX2
TAGAAGTCAAAA	EGR1
AGAGCGCTCGCC	EGR1
CTCATATAGTCT	PTPN6
TAGACACACTTA	NFKB1
GTACAACAAATA	NFKB1
TACTTATGTGCG	CTRL
CCATACTCATGT	CTRL
TGAACAGTAGAA	EGR2
GTCCAAAGGCGG	JUN
TTACGCGTTAGC	NFATC3
GCCTGATATCTT	CTRL
ACGGAGATTAAA	DOK2
ACAGCTGCCGAT	MVD
CCCACCCCGCNN	FOS
CCCACCGTAATT	RUNX1
CTGAACCTATTT	JUN
CTCTTTCGTTGG	NFATC1
GACGATCAATAG	ZAP70
CCAGTTTGGTTG	PTPN6
CAACTTACGGAC	CTRL
ACATTGACGACA	RUNX2
TTACACGGTATG	RUNX2
GGCGGGCTGTTN	CTRL
GTCGTGTAACCC	JUNB
GGGTTTTTATGG	CTRL
TGCCTATTGAAN	CTRL
TTGCTGGGCTCA	BACH2
TTTACCTAGATT	FOS
TCACCCTGTCTT	ETS1
GTCGAACCGAGC	NR4A1
GCCAGCAAAGGT	NFKB1
GCGATCCACGCC	FOS
TGCATCCTGCGT	JUN
CGCCTGGCTACA	EGR2
GCTGTTTCGCCG	BACH2
TGCCGTATTGAA	CTRL
GTGTGGGAAATG	ZAP70
AGGTGCACAATC	EGR2
TTTTCGAAGCTT	EGR1
GGAATGTTCCTT	CTRL
TGTATAACTATC	CTRL
CGCGCTATTTAT	CTRL
GGTTTCTCGCGG	ZAP70
ATCCTCTGGATN	PTPN11
CCCTAACGTGTT	NFATC1
AACCTCGACACA	LAT
CCGTTTAGCCAA	CTRL
CGACATGAACTT	JUND
GGACACCGGGAA	PTPN11
ACTAACGGCAAN	DOK2
AGCTACATCTGA	CTRL
TCCGTGGGTTCG	JUNB
GTTACTTACGCA	NFATC3
AGATAGCCCGCG	NFATC3
AATTCCCCACCA	CTRL
ACAGGGATATCA	EGR1
ACTGTCTGCGTA	RUNX2
TTCGGCCATTCT	CTRL
AAGGAAAATATG	JUN
CTTCTTTTATCG	LAT
CGCACACCGTCT	CTRL
AATTTTCCGGAA	EGR3
TCATGATCCTCC	CTRL
GCCAATTGAGAA	NFKB2
CTACTTCACGTG	RUNX1
CTGTCGATACAT	CTRL
CGTTTTTGTTCT	REL
TAGAGGGTAGAN	JUN
AAAAGTGAGTTT	BACH2
CTGGACGCTAGN	DOK2
TAAAGTGTTTTT	ZAP70
ACTACTTCCATA	PTPN6
CCGTATCCTGTT	CTRL
GTGTATAGGGAG	EGR2
TCTGACGTGAGC	NFKB1
CATTGACAGTAC	NFKB1
GCACTATAAGCG	CTRL
CTCTGCCGTGCC	RELB
TTTCGTAGTTAT	RELA
CTATCCACGTTT	CTRL
GCTTTGCCGACA	NFATC3
TAACTTGCCCAC	CTRL
GTGGTTACAGTA	LAT
TTCTTAGCACTC	NR4A1
TACAAGCTGACT	FOS
ATTAATGCGAAT	NR4A1
TTAATTCAAGAC	NFKB1
CTATGTGTTCAT	BACH2
AGCTATCCACTT	CTRL
GTCAACACCCTN	ZAP70
CATCAAAAATCC	PTPN11
TTCCTGGAGTTC	CTRL
TTGATATCCATC	CTRL
ACGATTGTTAGG	JUNB
CGAGCGACGCCC	NFKB2
ACGTGGACCCTG	FOS
CCAAATAGTATC	FOS
CTAACGACAATA	NFATC1
AGGGAGATAGGN	NFATC1
GAATTCACGTAG	CTRL
CGAGGCCATCTG	NFATC2
GGCCAGGGTCAT	LCK
ACGGAGACGGTT	NFATC2
GGCCAACGCGGG	CTRL
TTCACGCTTACA	FOS
CTAGACACCGGA	RELB
CCCACAACGCTT	CTRL
TCGGACTGTCAT	EGR3
CGCAAGCAAAAT	ZAP70
CTGCAGACGTAN	DOK2
CTTTTGGCTCCN	JUNB
GCCTGATTTTTA	CTRL
GAGCGTGCCCAC	EGR2
TCCGGACTCGGT	EGR2
CGGCACAGCCAG	CTRL
CGCATAGGTACC	CTRL
TTCTCGTAACGC	CTRL
AAATCCTGACCG	BACH2
CCCTCCTGATGT	NFKB1
TAGATGACGTTC	CTRL
TCTTGTCCCATA	RELA
TACCTGGAACTA	LAT
GCGCGCGCGACT	NFATC1
GGTTCAAGACTN	RUNX2
CTATAGCCTAGC	REL
TAAGATTGGTGA	PTPN6
GCACCCGCAGAG	CTRL
GTCTACCCTAGC	NFATC1
ATGTGGCATTTG	BACH2
CAGGCGCGTGTG	CTRL
CACTGTGAATAA	BACH2
TATACATTTGAG	CTRL
GATTATAGTCTG	NR4A1
ACCCTCCTTAGA	CTRL
CCCGAAATAGCT	BACH2
GATCAATTTCGT	EGR1
GAGGATGGCTCT	NFKB2
TTAGATATCCGG	DOK2
TTTATCAATGGG	EGR2
CTCGGCTGTCAT	JUND
GGGCCGTTAACC	LAT
TAAGCCCCTGTC	CTRL
TTGGATAGCGGG	CTRL
ATTTGTGTCCCC	JUNB
CTCATCCTCATC	JUND
ATGGGAGGGATC	RUNX1
GAAGCTTCGCGT	CTRL
GCGACGATTTCT	NR4A1
GCAGCCGTGGAG	RELA
CTGCTCCGTTTT	RELA
TGATCAGATCCG	RELB
TTCCTGAATGAG	CTRL
AGCGCTCCACCA	RELB
ATCAAAGCGATT	LAT
GACTTCAGCTGN	CTRL
TCGCTATTCGCG	EGR1
ACGGCAGTCTTA	BACH2
CGATCCCCCAAG	CTRL
AGTTTTCTGGGG	CTRL
TGGAGTGTATTN	CTRL
ACGGTTCGGATT	EGR3
AGGAGTTTACAA	REL
ATATAAACCCCT	RELB
GTTGAATTCGAC	FOS
ATCCCCCCCCAA	MVD
TGCATCGTAATC	REL
CTCTAGTGCGCG	PTPN6
AGGACAGGGCCC	NFAT5
GCAAGGATAACA	NFATC2
CCTTTTCACCTG	NFATC1
TGACTTGTCGAN	RUNX2
GCGGTGTGTGTC	NFATC2
CATCTCTGTGAT	CTRL
AACTTTTTAAGT	JUN
GCCGCATCACGG	FOS
TCCTTAAGCGGT	CTRL
AACGAGGCAATC	EGR1
TAGATTTTACCC	CTRL
ACAGGGACAGAT	NFKB1
GCACGCACACAT	CTRL
CTTACAGCCTTT	GATA3
GTCGTGGAGGCA	CTRL
CACTTTGGGTTN	NFAT5
CGCAATTGGGCC	CTRL
CCGTCTGCATTC	CTRL
TATCAATTTTAA	CTRL
GCGATCCTTTAC	REL
ACGCCTTCCGCC	RUNX2
AGTAGTAACCTG	LCK
ATCGTGTAACCC	JUNB
CCACACTACTAT	NFAT5
TAGACTTAGTCC	NFKB2
CTAAACGATGCT	FOS
AGATTACCGTTT	NFATC3
GGGAATGCCCCA	JUND
ATTTGTGTTTGT	CTRL
TCCCTGAAAGTT	FOS
ATTCTCTTAGTT	CTRL
CGCAGAAGGCCA	EGR4
TGAAGGTTCGCT	LCK
GTTGACCATTTN	NFATC2
ACCAATGAAGCT	PTPN11
ATATCTGTCAGA	LCK
GTTATGCGACCN	FOS
GTTGGATTCCAA	ETS1
TCAGCCCCTTCA	JUNB
GCGCCGAGATAC	CTRL
CAGAACGTAGAA	DOK2
GCACGGGTAAAC	CTRL
ACAACGTGAGTA	DOK2
CGGAAGATTCGC	NFATC2
CGTCTTCAAANN	JUND
GGTGCTGATGTC	RELB
GTCGCTCCGTTG	DHODH
TACGTTGTATTC	JUN
TCACCGCCGCAG	CTRL
GCTATCCCGTGA	FOS
AACACTCCCGAG	NFATC1
TCATCTATCTAG	CTRL
TAGCAGACACAG	NFKB1
TGATACCCCATC	EGR4
CTTGTAGGATTA	NFATC1
CCCTGGCATTAA	EGR1
GGCGTAGTCATG	NR4A1
TATCCAGATAAC	CTRL
GGCCCTTTCCCA	CTRL
CGCCAGCATGGC	EGR2
CGGATGACGCTA	NFATC1
TCACCGGTCCCT	FOS
GGAGACCGTGAN	DOK2
ATGAGCTAGAGG	JUN
TTCATTTAAGCG	EGR4
GGAGGTCTCCGG	JUND
TCCTATCGATAC	NFATC1
TGAAGTGTGTTC	BACH2
TCGCAGGGGTGT	NFATC1
GCCGCGCAGTGG	REL
AAAGCGCATTAC	CTRL
TCATACACACGT	RELA
ATGCTCTTAACT	PTPN11
GTAGACCACCCC	CTRL
TCAGGGCTAGTT	JUN
AGACGACCGTGA	JUN
CAGCAAGGACCC	RUNX1
CCCTTATAATAA	BACH2
AGAGAGGGTGCC	CTRL
GCTCTGCACAAC	EGR2
CACCACCACGCC	CTRL
TCACTACTTCAT	CTRL
ACCCCAATGAAA	CTRL
GACAGTGCGTAG	REL
TGCCCCTGAAGT	EGR4
GGAGGACCTGTG	CTRL
TCATGAGCTGGN	DOK2
AGGCCAAGCTTT	CTRL
AGCAACTTGCGC	BACH2
GCGTCATATTTA	DOK2
TGCTCGACCCAC	ZAP70
CACGTTGCCGAA	FOS
TCGTGTATTGGC	CTRL
ATTACAAATATG	DOK2
GACGTACAACTA	EGR2
GGGTCTGTGCCC	ZAP70
AGCCAGGGTCAT	NFATC1
TAAGGCGCCGTG	CTRL
CGGGTGGTCCCG	NFATC1
CTATGAAAATAA	EGR3
CGCGTCTCAGTC	REL
AGAGCGGCAGCA	FOS
ACTGTTATTCCG	CTRL
AGAGTCCGAGAA	FOS
ACGTTCACGGAT	REL
GGGGTTGGCTAC	EGR1
AGCTTAGAGCTC	NFKB1
GTTTATCTGCTN	NFATC3
GAGATTGTCAGA	RUNX2
TATACAATTGTA	EGR2
GGAAGGCCCATA	EGR1
ATCACTAGATTA	RUNX2
GTTCTCAGGGAC	ZAP70
TTGGCGAGCATA	NFATC2
GCCCTGATGTGG	NFATC1
AATTTGAGCGGT	NFKB1
ACTGAAGCTCAG	DOK2
CTAACCATGATC	DOK2
CCTGGTGCTAAT	CTRL
AGGTATTTGGTN	JUN
AATGGGCGGTTC	BACH2
CGCCGAGCAGTT	LAT
AGTCCTGTCTTA	CTRL
AGTCCCGGGATA	NFKB1
CGGGAGAAGGAC	CTRL
TCAGACGCGCGN	CTRL
GGAAGTAGGACN	NFATC2
ACTGACAGGCAT	LCK
TACGACGGCATA	EGR1
AAAGCCGGCTGC	JUNB
ACTACGAGGTTG	NR4A1
GGGGTGCGTCCT	EGR1
TGTTCGCGGGAC	CTRL
GAGCAGTAACCG	BACH2
ATAACCTATAGC	PTPN6
CTTTCTTGACGC	RELB
CGTAACCGACTA	NR4A1
GTGAACATTTGA	EGR1
AGAAGGTATGAN	CTRL
AATTTGGCCAGT	CTRL
GGCCAGCTCGGC	ETS1
GCTTCAAAAAGG	LCK
GATGGACGACGT	CTRL
ACCTAAATCGCC	JUN
GAGGTATCCTGC	EGR4
GAAACGTAACCT	FOS
CTCACAATCCTA	RUNX2
CGCTCTCGCACC	LAT
GCGCCACCCGGC	CTRL
GCCTCTTCGACT	RELB
GCTGTACGTTGC	NFATC1
GGCACGGACGTC	NFATC1
GAAGAGATTAAC	BACH2
GTAGACCTAACG	NFATC2
TAGTACCTCGTA	JUN
CAGAGGCTCGTG	BACH2
ATGTTAAAGATG	NFATC3
TCTGAATTCGAT	CTRL
GCTCTTTGGAAA	PTPN11
TGCACGTTCCAG	DOK2
GAGTGTCACGTA	RUNX2
GTACTGCTGAGT	EGR4
CAACAAGGGGGC	CTRL
GTGTGAAATTTT	DHODH
TGACACACGGCA	EGR4
TCATATAGTCTN	PTPN6
CAGATGGTACCG	REL
TTTTAGCACCGA	CTRL
CAGCCAGCAAGC	PTPN11
CGCGCCCCAGGA	CTRL
TTCTGTGGGAAC	NR4A1
TAACATCATCCA	CTRL
CCGAAGCTCGTA	CTRL
GTATGGACCGAG	EGR1
GTAGCACGGTCG	CTRL
AGATGAGTCCCA	CTRL
TCGCCCTTATCN	CTRL
CCGCTCTCTACA	JUN
GAAACCTGTAAT	NFATC1
ATAGTACTGATA	CTRL
TTTTGATCGATC	JUN
CCCCGACATCNN	CTRL
GTCCTAATCCAC	JUN
TTTGCATGTAGG	JUNB
CCGAGCTGTAGA	NFATC2
TGAGTCGGTCGC	CTRL
CTTAGTAGCTTC	NFATC1
GGTTGGGTATTT	PTPN11
GCTAGCAATTGC	NFKB2
TATGCATGGGGA	NFATC1
GCTAGCTCCGGG	REL
TAAATGCTGTAT	NFATC3
CCGTAATGTCCC	CTRL
TGAGATCCCTGT	NFATC1
TATACCGGAACC	PTPN6
AGAGTCTCGGAN	NFATC2
CGTCTGCAGGCA	RELB
CTAACGAAACGT	CTRL
AACCGCAGACCC	DOK2
GCGATCAGCCTG	EGR3
GTGACGTTTCAC	JUNB
TGCGACGAGGAT	CTRL
GGAGTCGCTTTA	NFATC2
CTACATTCCAAT	CTRL
GTCTTCCTGTTA	LAT
TTCGGTGGACTG	MVD
TTGACAGCTAAC	DOK2
CGGGCGTCGGCC	GATA3
TACATCTTTTGC	EGR4
GTTTGCCGTAAC	CTRL
GATTTTCCCCCT	CTRL
AGCCCATCGTGC	RELA
ACTGATAGGTCC	LCK
TGCCGTAACCTT	NFATC2
AGCTTCCGCTGA	CTRL
TAGGGAGAACCG	NFATC3
CCTTAGCAGAGT	RUNX2
AGTGTGTGAAAC	JUNB
GACTATACGCTG	FOS
TCTACCATAGAT	NR4A1
AGAGGATCAGCG	RUNX2
ACATCGAACATC	CTRL
CAAGTGTACCGG	NFATC1
AAGCAGACGTTT	CTRL
GAAGCGGGTGAG	RUNX2
ACGATCCGGGCA	BACH2
TCCGCGTTATGC	NFATC3
TGCAATGTTCCT	CTRL
CTACATTCGGGA	RUNX2
CACCAACCGCCT	EGR1
TTAATGAAGCTT	RUNX2
AAAAAACGTAGG	REL
TGGACAAACCGA	RUNX2
TTGTCGCACATT	LAT
GTGCAGCTTATC	CTRL
GTGTTTTCGCCA	FOS
ACGCTGGCTCTT	CTRL
CTATATTGATCT	TUBB
TCTAGCGTATCC	EGR4
GCTACTTCCATA	PTPN6
TCGGCCTACGTA	EGR1
TAGATTGGGTGT	GATA3
CAGTAAGCACTG	CTRL
TCTCGCTGATTC	GATA3
TAAGTAGTAAAG	REL
GAGCACTCTCCG	JUND
ATGTTAATCATT	NR4A1
TAGAGTTGGGTC	REL
TGCCCTCCGTCT	NFKB1
CCTGTCATACAT	RELA
TTTGGTCTACTG	JUNB
CAAGCCGAATAA	JUNB
TCTAACGTTCCG	CTRL
ACGTGACAGTAN	BACH2
TTGGGCTTGACG	REL
GTTCAACACCCT	ZAP70
AGATTGCGAAAC	EGR2
CGGCGCCTAGCT	FOS
AGCGTTTATAGC	NFKB1
AGATGCCGTATC	RELB
ACGCGCTACGCC	RUNX2
TACCTATGTTGN	PTPN11
ATTCTCGGCTTG	ZAP70
AATGTACCCNNN	RELB
AAGAACCCAGGC	NR4A1
GAGTTCGGACGA	EGR1
CTAGTCGTTGGT	CTRL
CACACTGAAAAN	CTRL
GGACTGGCTGTG	CTRL
CTCCGCTTTCAT	CTRL
TTGGCCTGCTAA	ZAP70
GACACTCTCCGN	JUND
AGCAGTAAAANN	EGR3
GTGTGCAATTCC	JUN
CGAACTCTAACG	EGR2
GGTGACTACAAT	CTRL
CAAGTAGCAACC	NR4A1
GTAGATTTCCTT	NFATC1
GGGACCCGCTAN	NFKB1
CCAAACATTATG	PTPN11
TGCTTGGAGTAA	NR4A1
GGTAATGACATT	BACH2
TATCCTGTCACA	LCK
GTTTAGCTTGGC	CTRL
TTCCACGAACGG	DOK2
ATTTAAATCTAC	RUNX2
GCCATTACATCC	PTPN6
GAACGACTAAGC	CTRL
CAGTATCCGAAT	FOS
TTGTGCCCCCTA	NFATC2
CGAGGTAGGAGC	CTRL
AGCGAGTGACGG	JUNB
TAACCAATTCAC	CTRL
GATCCACGTTCT	JUNB
ACCACTTTGGTN	CTRL
GAACTGAACGAG	EGR3
GTGCTAAGAGGT	JUND
GGAATAGGCGTG	NFKB1
CGCAGTGAGGGA	CTRL
TGGTTCAGACCC	RELB
TCGTCTTCTAGT	FOS
AAGGCAGCAGTC	CTRL
CCGCCACGACCA	EGR1
TATGACCCACTC	GATA3
TCAGCAGCAAAT	NFATC2
ATCACATTTATA	FOS
ACATGTGGGTAC	JUNB
TGGAAGGATATG	NFKB1
TCACGACCCGTC	NFATC1
GATACGCACCTC	CTRL
AGGTCTTACGAN	RELB
ATCAATCAGTCT	JUND
GAGTTCAGCGTG	EGR1
GCCGGAGTACTT	CTRL
CCCATAGCCTTA	REL
GCTCTTGGGGTG	NFAT5
CCTACCAACTTG	EGR1
GTACACTTAAAT	LCK
TCAGGCGTCGTN	CTRL
TCGATGAAGCTG	JUNB
AATCCCACTACC	CTRL
GCTTGGTCCCAT	JUND
TGTCCCGCACCC	RELB
AGACTAATTTAN	ZAP70
TTCGCCGTGCNN	EGR1
GGCCTCATATCT	JUN
TTATGCGAGGCT	NFKB1
CCGTATGAGACC	FOS
TATGACCGTACT	ZAP70
CCTCCAACTTCT	NR4A1
TCACGGAAGCTC	NFKB1
TGGTAACTGCTA	JUNB
GGCCTTTGCTAC	EGR2
GCCCAGACAGGC	LAT
CACTGACGCACC	MVD
TTGTAGCTACTC	CTRL
TTAAATGTTAGT	NR4A1
TGCTTTTCTTAT	NFATC1
TCAGCAGGTTAG	CTRL
TACAAACCTTTC	ETS1
GCGTGAGTCCGC	JUND
GTCTGAGAGGGC	NFATC1
ATTTTAGCCGAG	DOK2
ATGGATATGTGG	REL
AGGGACCTACTC	NFATC1
CGTGGAGCGTTC	JUNB
GAATGTAGCGTT	BACH2
CGAACGCAAAGT	NFKB2
GGTTTGTCAGNN	NFATC1
TCTAAAACTAAA	CTRL
ATGGTGGTAATC	NFKB1
GGTGTGCGGTAG	CTRL
TCGCTCAGAACC	CTRL
GCCCCTTGTGTC	NR4A1
GCAAGGGTTGAG	LAT
AATACTACTGCA	LAT
GAGGAAATTCGT	EGR1
CTGATAGATGCA	NFATC2
GGTTTTAGGCTG	JUNB
CACTTGTCGCAG	CTRL
ACGGGTAGGACA	NFKB2
GTTCGTGGGAAA	EGR1
CTGAGAAGAATG	FOS
AAGTGCGGACCN	CTRL
TCTTGGACTTCA	EGR1
GTTTTAGGAACG	JUN
CTAAGGAATTTC	CTRL
TCAAGGTACCAT	EGR1
CTCCCGCATAGG	EGR4
GATTAATGATGC	NFATC1
CGCGATCCTACA	RELB
CCTGTGACAATT	NFATC2
GTTGTTAGATGA	PTPN6
GGGGATAAGCGT	LAT
CTCATAATCAGG	FOS
GTGGTTCCTTGA	EGR3
GACTGCCCTTTC	CTRL
AGCCGAATTCAC	FOS
AGTGAATGTACA	PTPN6
GAAGAAATGACA	JUND
TGATCTGGTGAA	PTPN6
CTGATGGCTCTN	CTRL
ATGATCCGACTT	PTPN6
AACGCATGGTCA	RELB
AAGAGTACCCAG	ZAP70
GCGGCACACCCN	CTRL
CGCTACGAGGCC	LAT
TAATGTGGATCA	NFKB1
CTGCTTGTACTC	JUND
AGATTCAAAGGG	NFKB2
TGAGTTAAACAA	JUNB
AAGATGACGATN	EGR3
CGACACGACATA	REL
GCTATCCAATGA	JUNB
CGGTCCCTGTAT	LAT
GATCCGGATACC	BACH2
TCCACGGAGTTA	NFKB1
GCCGATACAGGG	PTPN6
GAAACACCCCGC	CTRL
TACTCGCTAACA	CTRL
CAATCATTGATA	RUNX2
GTGGATCCCTCG	FOS
CTCAAGGAGACG	RELA
TCTGTAAGGCAG	MVD
GCCCTGTCCTGA	NFATC3
CGCTCGCCAACT	CTRL
GTGGCCCCTGAG	JUND
CTCAGGTTCCGA	CTRL
GATAGCTGGTGC	LAT
CAGTGAGAACCT	REL
TTGGGGGTGTTT	EGR1
TAATCTTTACTA	CTRL
CAGCGGAAGCCT	BACH2
ATCTTAGAAGGT	BACH2
GCATATCTCACC	NFKB1
GAGGTCAGACAG	PTPN11
GATATATTTAAA	PTPN11
TATATGCTCATA	MVD
CCCCGGACGCGC	FOS
CAATGCTCCCTC	EGR4
TCAGTCCGATCC	REL
GCAAGGAGAACG	JUND
ATTTAGATGATT	REL
GTTAAACTTGCT	EGR3
TAGAATCTAGAA	CTRL
CTGTCCAGTGTT	PTPN11
ATACTGTTAGGT	NR4A1
CATTCTGTTTGT	NFATC3
AAGTGCGGGTCT	PTPN6
ACGTATGTAAGA	NFATC3
CAAGTCGGGGAN	PTPN11
AGAAACTACGTT	REL
GAGCGAAAGGTC	RELA
AACGGCATTGGC	CTRL
TTTCATTTGATT	LAT
GCCCGTTCCGCT	DOK2
GGTCCTTTGCGA	NFKB1
CAGCGATCCCTT	EGR1
CTACAGCACGTT	BACH2
AGCATGCACAGA	CTRL
AGAATGACCTCN	CTRL
AACGAGAAGGGA	CTRL
CTCCTCGGTCTG	NFKB1
ATTCGCATATTN	EGR1
GGTAGATATTTC	TUBB
AACTAGCCGGTG	NFATC1
TTCTCATGGCAA	RUNX2
ATAGACAGATTA	LAT
GGACGAACGGCA	ZAP70
GTGTCTATCCAT	BACH2
CGAAGTCTGAGT	DOK2
TACTCAACACAT	FOS
ATTCTCAGTCCG	EGR3
TAGACTATTGTC	JUND
ACGAGGCGTGTG	CTRL
TTCCAAGGATTT	LAT
GGGTATCAGCTT	JUN
ACTCTGGGGTTT	ETS1
GAAAGCGCACAT	PTPN6
CAATCTCCATAT	RELA
CTACAGTCGGAC	RELA
GTAGAACTGGCT	CTRL
TTCGTCAGTTTT	FOS
GTTCCAGGGAAC	NFKB1
TATTATAATCGT	RELA
ACATTGGAACTG	LAT
TAATCGCACGAN	ETS1
ACGAGGTCAAGA	CTRL
GTCATATCCTTA	NFATC1
GCCCGTTGTTGT	LAT
ACGCCAGTACCT	NFKB1
TTAGCTGCCATA	NFATC3
ATGTCGTCAACC	DOK2
GCGCTTAGAAGA	RELA
TCGATCGCTTAC	ZAP70
TTGTAACGGTGA	NFATC1
CTCTATGCGCCT	FOS
GAATCGGTTTTC	BACH2
CACCGTGGTGCT	MVD
ACCCATGCGCCA	GATA3
ATTCTAGTGTGN	CTRL
CGTACTGTGCCG	NFKB2
CGTGTTGAATTN	RELB
CCTTAGAGTAGN	ETS1
TGGAATACATAT	CTRL
AGTTTTCCCCGG	FOS
TGAGCCGCTCTA	JUN
TCGCTACCCACA	CTRL
CACCGAGTTCCC	NFAT5
CAATAGGCCTAT	CTRL
GACTCGCTTTAG	CTRL
TCGAAGCGGGTA	DHODH
ATTTTGTTGCTA	CTRL
AACAGGCTGTTG	NFATC2
AACATCTGCAAG	REL
GTACACCGATGT	CTRL
CTTCGGGTTGTN	NFATC3
AGTTCAGTTCAG	NFATC2
ATCGGATGTGCC	FOS
GTCTTGTCTGTG	RELB
GCCATCTAGACT	RUNX1
AATGAATGTCTA	DHODH
CGAGCCTAGCTA	RELB
GCAAGGAGGGTA	LAT
GAGTCACGAATA	CTRL
CGCCCAGGTGCC	NFKB1
AACCGCTCCCAC	JUN
ATGTACCCATCN	CTRL
TTTAGCCCGCTG	NFATC3
CATAATGTGCCG	REL
GAGATGGCCCGC	EGR3
GAAGAGATGTCC	RELB
TATTTTATTCTN	EGR1
TATAGCTGCGGA	REL
GCTACTTTCCTA	ZAP70
AATCGCAATATC	RELB
GACGGGATTATG	CTRL
TACCCGCCACGC	DOK2
TGACCTCACTAC	DOK2
AATTGAGTCTGT	NR4A1
GTTTTCTCGGTT	EGR4
CTGGATGGATTA	EGR2
GTTCCGGGAAGC	CTRL
GATTGAAAACGG	JUND
ACACCATGGACC	JUNB
CAGCCATCTGCC	RELB
AAAACCGTATCG	PTPN6
TTCAGTACGTGA	NFKB2
CTAGCTAATGTG	NFATC3
CTAGTTTATGCC	CTRL
TCACTTCACCTC	NFATC2
AGAGACAGCTGC	NFATC2
GCACGTAAAATT	RELA
GGTTATTATATT	CTRL
GTTTGTGTTGAC	CTRL
GAGGCGATTGAA	NFATC1
TATGTTTAGACA	EGR1
CGGAAACGGCGT	NFAT5
TGATGACATTCC	EGR2
TGTTCTTACAGC	GATA3
TTTCTCGGAACA	NR4A1
ACCCTAACCTTA	PTPN6
CTTGAGGTAGAC	CTRL
AAAGAGTTCTCN	EGR3
CGTGTTCGCGCC	NFATC3
TCTGTTGATCCC	DOK2
TTGTTGCCGACG	NFATC2
CTAGCCGGGAAT	CTRL
TGATTCCTGCAC	EGR1
CAACCTCTAGCG	EGR2
CCTCCAATGGGN	BACH2
ATATTACTCCCA	RELB
GAATGTCTTTTT	EGR2
ATTACTTATTCC	CTRL
TATGCGAGCGGA	GATA3
CGCACACCAAAG	CTRL
AGCACCGCGTAT	EGR3
GCGCAGGAGTTA	NFATC1
CCCCACACTTGG	EGR2
CGCAATGTTCCT	CTRL
TCGTGGTCAGTT	JUND
GTGATTGTTCAG	RELB
GCAAAACGTAGT	JUND
GCCCGCTTAACA	EGR4
TAACATATATAG	NFATC1
TTGATTTAAGTC	ETS1
CCTCCCAAGGAC	JUNB
CGTCGTAACAGC	FOS
TATACTACGCAA	EGR3
ACCGAGCGACGC	FOS
CTCTGTGCACGG	CTRL
CGCCATAATCCN	REL
GGGTGTTGTTTC	LAT
GATTGATGCAAT	RELA
TCCGTGTTATCA	CTRL
GGCAGAGCCATA	NFATC1
TTCCTTCAAGTC	PTPN11
CGGACTCACAGC	JUNB
CTGGAATCGGCG	GATA3
AGCGGTGGGTTC	RUNX2
TTATAACTTTCG	CTRL
TCCAGTCATATA	CTRL
TGGTAGGACAAG	RUNX2
TAATGGGTGCAT	EGR4
CGAGAGGCGACN	PTPN11
CCGTGATTGCGG	CTRL
CGTGCGCCATTT	RELB
GTGCTAGAGCCT	LAT
CTTTTTCAATCT	CTRL
AATTCGATAGTG	DOK2
AGACCCCGTCTT	BACH2
TGAACCAACATT	CTRL
TAATTGACACCN	EGR1
TGGTAGACCCGC	RUNX1
AACAATGTTTGA	LAT
TTTGTGAATACT	NFAT5
CGTGCCCGCGAC	CTRL
GGGGCTTCCTGN	PTPN6
TTCTCAGTCCTN	EGR4
GTGCTGGCGTCT	REL
CAAAGAGTTGAC	EGR3
CCGCCCACGCTA	PTPN6
CGGAAGGACTCC	JUN
GTTCAGTTAAGN	ZAP70
CCATCCTAAACG	EGR2
CTGCCTACTTTC	JUND
CTTAGTATGACC	JUN
CCTTTAGGAGGA	NFKB1
GGTGCAGATTTT	NFKB1
CGCTAAAGCCTT	NFATC1
ATTTCCATCCGA	RELA
CCCGTAATAGTA	DOK2
GCAACCGGTTTC	NFAT5
ACCGAAGATCCA	DOK2
GTCCGACTCTAN	EGR1
ATGACTGGAAAC	EGR2
AATTTAGACAAN	PTPN11
CAGGAGTTTACC	DOK2
CAGGTCTGGACA	EGR1
ACGGAAGAGTCA	CTRL
AGTCTCCGGAAA	JUN
CTTGGGGATCCA	DHODH
CCTGTGCCAATN	NFKB1
AATGTCGTGAAG	JUND
CGCTCTCGAGTT	NR4A1
GCGCTACATATT	CTRL
AATCTTGGGGTC	RELA
GAAAACCCCAAT	ZAP70
CCTTAAAATAGG	RELA
TAAATTTGATGA	RUNX2
AAGATCGCTGAG	JUN
GTTATTGCCTCC	JUND
TTGGTCCGCAGN	LAT
TAGGTCCTGTAC	ZAP70
TCAGCTGTTGGA	FOS
TGTTACGACGAC	JUND
CAAACAAGGCAT	RUNX2
AGGGTCCACGTG	RUNX2
AGATTTAAAGGT	JUN
AGAAGGGGGGCG	RELB
ATGGAATCTATT	RELA
TAAATATTACTC	PTPN6
TTTGGGGGTAAG	NFATC3
ATTTGAAGCCTC	CTRL
CAGACTAATTTA	ZAP70
GTAGACGGCTAG	GATA3
CGAAACTCTGTC	FOS
TCCAGCACGAAG	NR4A1
ATCATGCTCTGA	BACH2
AGATGACCCGTA	NFKB2
CCGGTTGGACGT	BACH2
CCAATCCCTGCC	EGR1
AAAGTCTGAAGG	NFATC3
TTTGAGGCTTAA	NFATC3
CGTGGATCCGTC	CTRL
GCCCCCGAGTCT	CTRL
CGGGACACGCCT	RUNX2
AGATACCGGACG	NFATC2
AATTGGCAAGTC	LCK
AGTAATCTGTCG	LCK
TTTTCGCCAGGC	JUND
TTCACTCAATCT	LAT
TGCTGTATGACN	EGR1
ACTGTTGCCGTN	EGR3
CTCCGGGCAGAT	EGR2
TCTGATTGCAGC	NFKB1
GAGATGGAGGAG	PTPN6
AACGCTAGGTCT	ZAP70
TGCAAGGCCATT	CTRL
ATCGTGGCGGAG	NFKB1
CCTCCTACAGGG	RELA
TATCGATAAGTA	BACH2
GAATGAGCAGCT	CTRL
GACTTCGTCTAA	DOK2
TGATCTGATGCG	LAT
TTGGTTCTCGGC	NFAT5
GCCGTTGTTCGC	JUNB
TAGCAGCCGTCT	CTRL
AGGGCGTCACCT	FOS
GCATCCAATCCA	CTRL
AAAGAGACGAAA	PTPN6
CCTTAGCCAAAA	LCK
GAGAGAAGCTGC	CTRL
ACTGTGCAGAAT	NFATC3
ACCCGTACCAGA	RELB
AATCAGGACGGA	NR4A1
ACTGCGGAGGCC	CTRL
TTATTTAGCATA	NFATC3
TATCATGAAGCG	NFATC1
ATGTACTACAAA	JUNB
ATACCCCCTTAG	PTPN11
GTGCACCCTCCA	NFKB2
TCCTTTCATCAG	JUND
AATGTCCCTCGA	PTPN11
CTGCCAACGATC	JUNB
GCAATAAGCCAC	JUNB
CAGGGGACAAGG	LAT
GCTTGTCCCGCC	NFAT5
GTCAGCAGCGTT	NFKB1
ATCAGAATCACG	REL
GTTCCTCCGAAC	NFATC3
CCCCGGGTGAGC	NFKB1
AACATTTGACAG	RELB
ACACTATTATGA	NFKB2
ACTTCATACTCN	RELA
GGCAGTCAATGC	NFAT5
TTTTCGCCGGGG	CTRL
GCGAGGTCAAGA	CTRL
ACGTGAAAGGTT	CTRL
AAGCGATTACAT	LCK
AGCGCTCTTCTG	CTRL
CCGTTTGCCTGC	CTRL
GTATCGAACGAG	JUNB
GGCCCTGATCAC	FOS
CATGCATACGTT	EGR4
ATCCGCAGGGCC	ZAP70
ACACGCGCCCTA	CTRL
CTATCAATCTAT	FOS
GTAGAGACCCAC	ZAP70
TCAGTGCATTGC	NFKB1
AGCAAGATCATC	RELA
CTGGAGATAACA	NFAT5
AGGAAGCCCACA	NFATC1
CGGTTGGCATAN	RUNX1
ACTGGTCAGCTT	LCK
TATCTAACGGAN	MVD
CGAGTGGTGTCT	CTRL
AATCCTATAGAC	REL
GGTGTCCACATT	GATA3
ACCCTGAAAACA	DOK2
CGCCAACCATCN	NR4A1
TTTGAGGATCAT	EGR1
ATCATTCCGACT	BACH2
CGGCTTAGATCT	EGR3
CAGCCCTAGTAC	EGR1
CACCTTCTCCTA	CTRL
CGGATTAGTTTA	LAT
GACCTCGCATCC	BACH2
GCCCTAACCTTA	PTPN6
CAACACTCCTAN	EGR2
GGCAGCCTATGT	LAT
CTCCACGAACCC	JUNB
CTCCCTGGAAAT	JUND
CTCTTTGTTGTG	CTRL
CCTTAGTCACAG	BACH2
TTGTGCGCATCA	CTRL
GTTATACTAGAC	NR4A1
ATCAGGTCCCTG	CTRL
TAGCAAGGACCC	DOK2
AGGAACCGGTGG	EGR4
GATTTAGGTACA	CTRL
GGGGCACGTAAC	EGR4
TGATATTAAACT	REL
ACTTCGGTCACC	CTRL
GGGAGAACACCA	CTRL
GAGTGCCTGGTT	CTRL
GAGAGCCAGGAN	EGR4
GAAAGGGTGGGT	EGR1
AATACCTTTCAC	NFKB1
GCCCATAGTAAG	CTRL
CGCTAAGCGAAT	MVD
CACCCATTTGAC	REL
AGTTAGTTCGAT	ZAP70
TAATTTGTTGAC	CTRL
CGGACTCATTAT	JUN
GCTGCTTCCCAA	LAT
GTAGAGTTTAAT	NFATC1
GTATTCAATGGA	CTRL
GTGTCTGGTACC	CTRL
TAGATCCTGGTC	EGR4
ACGGCCAGGCTN	NFATC3
ACAATCAGGAGT	NFATC2
TCGTTGGCTCGT	JUN
AGCACGCAGAGA	RUNX2
CCCCGTACCANN	RUNX2
CTAACGCGCACT	CTRL
ATGAAGTAACCT	EGR1
ACTCTTTCTGAC	CTRL
TTCTGTAGCTTT	JUN
GATTGTTATGGT	JUND
CGGGCCTGCGTC	CTRL
CACGACGATACT	DOK2
AACCTGATACGT	FOS
CTTTTGAAGTTG	NFATC2
AGGCAGAAATAN	FOS
ATCGTACCACGG	EGR4
ATCGCTTGGACT	RUNX2
ACTCCCTAGACA	JUN
TCGAGTCTAGTT	DOK2
AAACCAGCACNN	NFKB2
GCGACCCAATAA	JUNB
TAGTGACGGGAT	CTRL
CATATTTGATTT	BACH2
AAGCCCGGGATC	RUNX2
GAGTGGTGAGGT	CTRL
CAAACCCATCTT	NFATC3
CCGGAGCGATCT	NFKB2
CTTCTTCGCAGG	EGR2
CGCGATCGGTCA	CTRL
TCAAGCTTAAAG	EGR1
AGCTGAGGTGTT	EGR1
TTCTCGTACTCA	RUNX1
CTCTGGGGGGCG	NFKB1
CCCGTTAGTCCG	DOK2
ATCCGGAAGTGC	EGR1
CATAGGTGATGN	CTRL
ACGCGAGGCCGG	REL
ATCTATTACTCT	CTRL
ACTACTCCTAGC	NFKB1
CCTTCGGTACGA	LAT
CGGAACTTTTTA	CTRL
CCGGAGGAGGTA	EGR3
CTGGACGTACAT	NR4A1
CGCCTCCCCTCT	EGR3
GCGACAAGGCTA	JUND
CAGCGCATCAAC	DOK2
AACTAGTTCTGG	BACH2
TAAACTGAAATT	EGR1
TTCGTAGCACTA	REL
GTATGCGGTACT	RELB
ATGTCAACCGCA	NFATC3
CGGGCCTGGTCN	CTRL
GTCAACAAGGGG	CTRL
ATTCGTGGCGAG	NR4A1
GATCACGGCATG	CTRL
CATTATTGGTTT	NFATC1
CTTCAAATCTCG	NFKB1
AACCGAAAGACG	CTRL
CAGTGTAGGCTC	JUN
CGTACTGGTCAA	RUNX2
GTTGTTTCAAAA	NFKB1
TCATCTTTTCGC	REL
GTAAAGAGTGTA	LCK
AATTTCGCGGCG	LAT
CGCGATTGGCTT	RELB
CAATCTCTCCTC	ETS1
AGCGTCGCCATA	ZAP70
GACGGTGGAGTC	FOS
GAATTACATAAT	NFKB1
AATCTCCGTTTA	NFATC1
GTGCAATGCGGC	CTRL
GACGACAAGACG	PTPN6
ATGACAGGAATG	NFATC1
AAGACTGGGTCA	JUNB
GATTGATACTGA	NFKB2
CGATAAGGCTAT	LCK
CCGTTTTTTAGG	BACH2
CATAGCGCGATG	NFKB2
AGCCTTTGCTAC	EGR2
ATATCTAAATCG	NFKB2
GCCGAAGATCCA	DOK2
TTCGCCAACGAC	NFAT5
TGCGACTTTTAT	NR4A1
GCGTCTATGAGG	NFATC1
AGACGTACTCGA	CTRL
GATGCAATCTAN	CTRL
TGAATCGCACGA	ETS1
CGTAGTAGGCCC	DOK2
GTATCCAACCCA	LAT
AGTTTTCTCTCG	CTRL
ATCTGGTTGTGN	EGR2
CGGGTACGAGGC	NFKB1
AACATGCTGTTA	NFATC2
CGTATACTTTAC	CTRL
ACCCAGAGTTAT	JUN
TACTCATAGTGN	NFATC1
ATGCTTTTTTGA	JUNB
AACACCCCCTTC	RELB
GCTGGTTGTACA	JUNB
GAGATCTGGCTA	JUN
TAACTTTGGCCC	EGR2
TGTTTACGCACG	CTRL
CTGGCTGAGGCC	ZAP70
AGACAGGACTGA	LAT
GTGAACAAAACC	EGR3
CTTATCCTAAGC	LAT
GCATGAGCCCAA	NFATC2
CTGAGCACGTTC	CTRL
ACCTATCGGGAT	REL
CCATGGTTGCCC	BACH2
ATGCACAACTTA	CTRL
CGGCTCACTGCA	CTRL
CCACGTAGCCTA	EGR3
TAATCTCAGATT	NFATC3
CTTCCAATCCGG	PTPN11
AGCCGCGAAGGG	RUNX1
GGATCGCGTTTT	CTRL
AAGACGCCGTAA	NR4A1
CCAATGAACTCC	DOK2
CTTGTTGTTCTC	EGR2
TCTGTACAGAAN	NFATC2
TACACTCCTCTA	NR4A1
TCAATAGCCGGC	REL
TTCTCTTGACCC	CTRL
GGTTGAAGACCC	RUNX1
TACAAGCGGTGA	RELA
GACTCACTCCTT	EGR2
ACAGCAAAGAGT	CTRL
CAGTGGCAGGTT	NFKB2
TTCCGACTTCAG	CTRL
AACAGGTGTTTC	RELB
AGGGCATTAACG	CTRL
AAATACAATAGA	LAT
CGCATCGGGCCA	RUNX2
AGCAGTGAAGCC	PTPN6
ACGTGGCGTCTT	FOS
TATTAGCAGGAT	NR4A1
GTACTGTGCCGN	NFKB2
GAATAGCCACAC	EGR4
AGCACCATAGCT	CTRL
TAGCCGTCTAAN	EGR2
GCAGAGCTATTT	EGR1
GCCGCACCCGTC	JUNB
ACCATAAGGTCG	FOS
GTAGGCTTCTTC	NFKB2
CTACTCTGCGCC	CTRL
CTGTAACGGCGG	PTPN6
ACCCTGGTCAGG	ETS1
CATAGTCTATAG	CTRL
GATACACACTGA	CTRL
CACTCAACCAGC	NFKB1
AATATTGTCAAT	NFATC1
ATGAGGATACGG	REL
TCCGGGCTGATC	NFATC2
AATTTAGTGTAA	NFAT5
TGTTCAATTCAA	NFKB1
TCGATGGAATCN	CTRL
CAACGGGTTGCG	CTRL
CAATCGCACAGT	EGR4
CCCTTAGAGTAG	ETS1
GTTAAGATGCTT	NFKB1
AATTTATAACCA	BACH2
AGCACTGCTTTC	NFKB1
GAAGCATGGTCG	NFATC2
GTCGATTGGGGT	JUND
AGTTGTGTACTG	JUND
GCAGTGTGACTN	JUN
TGCATACTATGG	ZAP70
GCTAACCTGGGG	CTRL
TTCGTAACGAGA	CTRL
TGCCTGGTAATT	NFATC1
CTCAGTGACCAC	REL
ACGATTGCGGAG	NFATC3
AAGTTTGTTGAT	FOS
AGCAGTCGCGAN	EGR4
TAAAGTCGAACA	PTPN11
TATGCCCGCTGA	REL
TCTCGTGCAATT	JUND
ATTTCCGCGACT	CTRL
TTTTGGTAGTTA	NFATC1
CAGTGTGAATGT	DOK2
TCAACTGCCCAC	CTRL
GGGCCATGCGCT	BACH2
AGGATAGAGGTA	CTRL
GCTAGTCGTTCN	CTRL
TGGACGTTTGTC	CTRL
AACCCGGTATGT	NFATC1
CCCCATTACCAT	CTRL
TTAATCAACAGC	EGR3
TACTTAGAGAAG	NFKB1
TATTACTCCATG	JUN
CATGTTATGCGT	MVD
ACGCCTGTAGAC	BACH2
CGGAAAATTAGG	CTRL
TCGATCTTAGGC	JUND
ATTTCATCCGAN	RELA
AGCAATCCCAAA	RELB
AAGAGCTTTCCG	NFKB1
GAAAAGACCCGT	JUND
ACGCATCACGAC	NFATC1
AACTTGTCCATC	CTRL
CTCCGCAAACCN	CTRL
AGTTGTTCGATN	ZAP70
CCAAAGGCCGAA	RELB
GGACTCGCCTCG	JUN
CGTACTAACCTG	CTRL
CGGATCGGACCN	EGR2
AACACGGTTCTT	CTRL
TTACTGCGCCCA	CTRL
GTGATGATTTCC	CTRL
CCCTTTATACCG	NFKB2
GTTTTTAGACGG	NFKB1
GCTGATAGAAAA	NFKB1
CTAGTTGTCCAT	JUN
AGATTACGTACT	PTPN6
ATAAATGACAGT	NR4A1
GAATTTAAGCGG	REL
AACGGCCAGGCT	NFATC3
TCGTCTTAGCCN	CTRL
ATGTACTTGCAN	PTPN11
GCTCTTTCTGAC	CTRL
TACTTATTTGAT	EGR2
GACCCAACTGAG	NFATC1
ATCATTTATCCC	CTRL
GCAATCAGGAGT	NFATC2
TATAGTATCATN	NFATC1
CCGTGATACCTC	PTPN6
TATGCCTGCGAA	EGR1
GAATCTCTCCTC	ETS1
TGACACCAGTTG	NFKB1
GTATAAAGGCTC	DOK2
CGCATGGAGGAN	NFATC3
GGGGAATATTAG	NFATC2
TGATGGGCTGTT	EGR1
GTACAAGCTCGC	RELB
CTCAATAATTGG	EGR1
CCCATCATATAC	ETS1
GCTGTTTGAGAN	CTRL
TCCAGGCTCCCN	CTRL
TGCCGTGTCATT	CTRL
ATGAAAGCGAAC	ZAP70
CCCATCTAAGGC	EGR4
CGATTGCGCGCG	CTRL
TTCTGGGGATGC	PTPN6
ACTTAGTTAGCG	RELB
GAACTAACTTGG	JUN
ATCCTGACCGAN	EGR1
TGGAGGGACAGT	EGR4
CCTTCAAGGATT	NFKB2
GAGGAAGGAGCG	NFKB1
TCCCCACCGTGG	CTRL
TCCGAGATTCTT	CTRL
CTTTCCAGTATA	DOK2
CATGAAATGCCN	NFKB2
ACACCTCTAACG	JUN
TTAGGGTCTTGC	NFATC1
GAGCCGTACTCA	CTRL
GCTGGATTATTA	CTRL
AGGCTAATAAGA	CTRL
TATGTTCCATAT	FOS
GCGGCGGGCACC	NR4A1
GAACCAGCGGTT	BACH2
ATGCATGAGAGT	CTRL
ATAATGACAGGN	CTRL
GCAACAGAAAAT	REL
CATCAGAGTCGG	EGR2
GGGCTAAGAGCA	JUND
ACCGTCCTGCAN	NFATC1
ATTTAATGCACG	NFATC2
GAGTTCTTCAAN	NFAT5
ACGTTTCGCATG	NFKB2
CTCCCCTCGCAT	EGR2
ACAATGACCCGA	CTRL
CTCAGCTAGGAT	NFATC3
TTGCTCAGCACC	JUND
ACGATGATTCCT	EGR4
TGAAAGGGATGT	CTRL
CCAGACGAGATA	CTRL
AAATAACGCACT	RUNX2
AGTCAGCTAATT	NFATC1
TGCCAATAAGAG	NFKB1
AACATACAAACG	REL
GATTCACGCCGC	FOS
GACGCGAGAATG	EGR4
CCGGGAGCGCAT	CTRL
AAGAGTATCCCA	NFATC2
ATCATCGATCGC	NR4A1
CCCGAGACTCCA	CTRL
GTCACAATATCT	CTRL
GTTGGGCGTCAC	CTRL
ATGGCTTAGACC	EGR2
TTTGCTATTTGG	MVD
ACAAAACACGGC	CTRL
ATCGCCCGCCGA	LAT
GTAGATTTTATC	FOS
TCAGTGACTCCC	PTPN6
TGAGACGGAATC	PTPN11
AGAGACGTTTCG	CTRL
GACGACGGATGC	LCK
GATCATGCACTG	REL
TGGTGGGTTACN	CTRL
AGCCAGGCAACA	PTPN11
TGTTCAAACTGA	NFKB1
GAACTATACACC	NFATC1
ATTGTGTGGGTT	NFATC2
AAGTACCAGCCT	RELB
TTCTTGATAGCG	EGR1
CTTCAACGACTA	RUNX2
GACATTGAATGN	FOS
TGTGATTTAGAT	RUNX2
GCTTAGAGGACA	RUNX2
TAGGTGTTCGAN	CTRL
CAGTTATCTCGA	NR4A1
CTTAGGACACAG	RELB
GGGAAAGTCCAA	JUN
CTGGCGAACCGA	RELB
GTCCTAAAGTAG	PTPN11
CTGACCCTAGAA	RUNX2
CTGCATAGATGA	RUNX2
CAACCTTATACG	NFAT5
TTTAAGCTGGGT	EGR4
TATAACGTCTTC	ETS1
CTCTTCGGCCTG	BACH2
ATCTAAAATGCC	CTRL
GGATAGCACCAC	PTPN6
AACGCGAGAATG	EGR4
AGGTTTGGGTGT	RELA
GCCAAAGGGAGC	JUN
TCCCTACGCTAG	CTRL
CAAGCGGGGCGT	BACH2
TATAATTGAGGC	CTRL
ATCAGTTTTGGN	EGR3
TCCTCACTGGTC	PTPN6
TGCTCACTATAA	ETS1
GTCTGTGGCGCT	EGR3
CTCCCCTGGGAN	LCK
CTCCCCTGGGAA	LCK
TTAATATAAATC	CTRL
AGATACATGACC	EGR2
ATTCGACGATGA	BACH2
CCCTTGGCGATG	CTRL
TAGTAGCAATGC	NFATC2
GGTCTCCCACTT	EGR3
AAGTCCCGCCCT	NFKB1
TTTTAGCTACGT	NFKB1
GCCCTGCGGCCC	RELA
GCTATGGCATCG	PTPN11
CACGGAAGAATA	NFKB1
GAATTGAAGGGT	RELB
GAAAACAGCACA	PTPN11
AGCGGGGATCAT	BACH2
CCTTTAGTTTGG	CTRL
ACGCCTCTGGGA	PTPN6
TTAATAACCTAA	RUNX1
CAGGAAAGCTCA	NFATC2
ATCACACTTATT	NFAT5
TAACTGCCGATT	JUN
GCGATGATTCCT	EGR4
ATCAGTTGGCAG	PTPN6
TATCGCCTTGTG	RELA
CAGTCGGATCGA	TUBB
GCCTGTAGCTGG	NFAT5
CCTACGAGCCCN	CTRL
ACGAGAATTCGC	JUNB
ATCCTAAAGTAG	PTPN11
AGGAAAGTCCAA	JUN
GTCGCCCGCCGA	LAT
AGTGTACTTGAC	JUND
GAGACGGGGACA	BACH2
CGACTAGAGAAG	CTRL
CAGTAGAATCGG	NFKB2
TTGCCCAGCGTC	NFKB1
CGACCGCGCAGT	FOS
AGCTGAACTGTT	DOK2
GTGGCGTCTATC	DOK2
AAAGTCGTTTCC	EGR3
TCTGTACATGTT	EGR2
GGCAAGTCTTGT	RUNX2
CACGCAACATTA	NFATC1
ACTTGCTCGAGA	EGR4
TCCTTATTCCCN	ZAP70
ACTGGTGGTTTT	NFATC1
CCTAGTGTTAGG	CTRL
ACGAGGTTTCTC	CTRL
CATTTCTGCAGA	DOK2
CTGGACGGCCCC	EGR1
ATCGAATCAGAA	RELA
CACGCAACAGAT	FOS
TGGCGGCTAGGN	EGR1
TACTTGGAAGAC	CTRL
AGGAAAGGTCAN	CTRL
TTAAAGCGGGGG	RELB
GTATCCTCCCTN	CTRL
GAACCTTGGAAN	CTRL
CGCGCTCAAAAC	CTRL
GATTGCGTGGAA	EGR1
CGGCACAAGGAC	NFATC3
TATATGGGACTG	FOS
AGTCACTCGCTC	FOS
ATAGCGGGGTTT	CTRL
ACGCCGCTTCGG	CTRL
CACATTTACCCT	FOS
GTCGTATCCGCC	DOK2
GCGGCTTCTCAG	NFKB1
ACAACCTTACTA	EGR2
CCAAAGCGAGAG	NFATC3
CTACCGTGGACG	CTRL
GTAGTTGATTGC	CTRL
AAGAACTCGCAA	BACH2
TCGAGAAGGTAA	PTPN11
GTGTGTAAGTAA	PTPN11
ACTGATAAGGAA	NFKB1
GGTCATAGGGTC	CTRL
CATCATTTGGTA	CTRL
GGTATAAACCTT	FOS
CATAACTACTCT	RUNX2
TCAGCCCCTGCC	LCK
CATATTATCACC	JUND
AACCAGATGTTG	RELB
TAGGACAACGCA	LAT
CAAGATACAGAG	FOS
GTAACGCCCGTA	PTPN11
ATTGGATGGCCC	ETS1
CTTTGAGATTAC	DHODH
TTCGTAACTGGA	RUNX2
TCTGATAGAACC	JUN
AATGAAAAGGAC	GATA3
TCAGGGGGATTC	NFATC1
GGGGAGCATTAG	NFATC1
GCGGAGGATCAC	NFATC2
CGGTTTTTAGGG	REL
GGTATCTATCTT	NFKB1
ACGGATCTTGTT	RELA
GAAAATTCTGGT	PTPN6
AAGGCTACTAAT	JUNB
TGCTGATTAAGT	NFKB1
ACACTCGCGTGA	LAT
TGCAGGCGTACC	DHODH
GTACGCGTTCGC	ETS1
TCATCTATATGN	REL
TCCAGCGGCAGA	JUNB
AATAAGTTCCCT	NFATC2
CTTGGTGTAGCA	CTRL
CTCAGGAGCCAT	GATA3
CTTCCCGTCCTC	NFATC3
GAAGACTGCTTT	EGR1
TTATACTCCTGT	CTRL
ACGCTTGGTCAC	DOK2
GTTAGATATTAA	NFAT5
TAAAAGAGTGGA	NFKB1
TAAAAGAGTGAN	NFKB1
AACAGACTGAAN	CTRL
TTACACATTGAG	CTRL
GAGTGAGGGACA	NFAT5
GGCGTAGTAACN	JUND
CAGAACCAACGG	LAT
TTCAGTGCAATT	PTPN11
TGTGGAGTTAGC	NFATC1
CCCAGAGTGTCA	NFATC3
GGCGACCATTTC	JUNB
ACCGTGAAACCG	CTRL
TAAAGAGAAGCG	BACH2
GGGTATTCCTCA	FOS
ACTGTCGCACCT	EGR1
CTGCGGAATACG	FOS
ATGGAGAACCAG	CTRL
TGTAGATACGTA	CTRL
CACGTATAATCT	NR4A1
GGCCATTTGGGN	CTRL
TCGCTGACCACG	RELB
TAGGCATAGAAT	CTRL
CAATGTCGATTA	NR4A1
GTGACACTAGCC	FOS
AGTATCTTTGGC	LCK
GAGGTAGAGAAA	EGR4
GAGGTGTTGACA	CTRL
CTCAACTTACGT	EGR1
CCAGGTATGCCA	REL
GGTCCACCTTTA	NFATC1
CTTTATCTGCAA	NFKB1
CGGTGGGCCGCA	RELB
GGAGTAGCGTGA	CTRL
ATTTGGCCACTA	FOS
ACACTTAGCAAA	CTRL
CCCAGGTCACTC	RELA
AACTGGTTTCGT	EGR2
GGCAGTCGACCT	ZAP70
TTGCGGGACATT	NFKB1
CTTAGGCTGCCC	EGR1
CTTAGGCTGACC	EGR1
ATTCGTTGCGGT	JUN
CGCGGTGTCACA	DOK2
ATCGCATCGCCN	NFKB1
ATATCAACTGGT	RUNX2
AGTGGGACCGCN	CTRL
GTCTCTTCTGAC	REL
TGGTATCCACGC	JUND
GGTCGTAGAATC	RUNX1
ATCGTTTTTTTN	ETS1
CCGTGCCCCACN	JUN
ATGTTTTGCATG	JUNB
GAACACCTAATG	LAT
TGTCGTTAGGTG	EGR4
TGCTGGAGCACC	JUN
TAGTCCTGTTGC	RELA
TATGCTGACGNN	DHODH
GAGGATAAATAA	EGR2
TCATCGTTTTAA	CTRL
ATATGCGGGCCT	NFATC3
CGCGAGTGGCGT	CTRL
ACGTATAATCTN	NR4A1
GGCAGACTAATA	CTRL
TTTTACTTCTTC	LCK
GCTTAGAGATAA	BACH2
TGCGTGTTTAAG	EGR2
GCGCCCGTTCGG	CTRL
GCACTTTAATCG	BACH2
TCAGTTAGATCG	RELB
GTCAGTGCTGAT	FOS
CTCTCATAGCAT	ETS1
CTAAGCACTAAG	EGR4
CAGGACCATCGT	JUND
CAGAGGTACCGC	CTRL
GCGTCAGGCATT	EGR1
CAAGTGGCGGAA	JUN
GGGCTATTAAAC	RELA
AATGTTGCGATA	MVD
CCCCCGGATAAG	FOS
TTACTTTTACGC	NFATC1
GTTTTTACGAGN	ZAP70
AAACCTATTTGA	NFATC1
GAATGTGGTGAC	CTRL
CCCGGCTCACTG	RUNX2
ATGGGTATCAGA	JUND
GCTCGGTTGACT	NFAT5
CTTAAGCGGAAN	NFATC1
CGTACGGCGCCA	BACH2
CAGTCGCTTGCT	CTRL
ATTGTCTAAAGN	LAT
TGGAAGATCGTC	NFATC1
CGTCCTGCTACT	LAT
GGCTGATGCATG	JUN
GTCCCCCCGTTC	CTRL
GAACATCAGTCN	GATA3
TTGAGCAACTAT	NFATC2
GATGCGCTCTTA	JUN
ACTGTCACCAGG	JUN
AAGGAGCGAATC	NFKB2
ATGAATCCTGTC	ETS1
TTGCCTATTTTG	JUND
TGCCCCAACTAN	RUNX2
CCGGGTGGTGAC	EGR4
CTAGAAGAGCTC	FOS
GCTAGATGTCAA	EGR2
GCCGAGTCTCTA	PTPN11
TGCTTATAGAAG	NFKB2
ATCTAGGTTCAA	BACH2
GCGGGATGTTGG	EGR1
TATATCGTTCAG	JUNB
GATGGTGCTCAC	CTRL
TGTTCGGCGTAA	EGR1
ATGTGCGACATN	FOS
GACCCTCTGTCT	PTPN6
GACCCTCTGTTC	RUNX2
TGACCTGTCCGT	RUNX2
GGAACGCAAAAG	NFATC2
GACTCGGACGAC	PTPN6
GACAAGAGCAAC	GATA3
GTCTGCGCAGAN	NFATC1
TAGCAACCCCAC	FOS
ATCGATGGTTTN	ZAP70
GTCATTAGCATA	DOK2
TCTAAATAATCT	FOS
GTTGGGTTGACC	NFATC1
GCTTTCGCCTCN	JUN
TAAGCGCCCTTC	BACH2
GCATCTCTGTCC	NFKB1
GTGCATAGTGTT	DOK2
TGTCCTCTGGGA	NR4A1
CGTTAATCTCCA	NFATC1
GTCTCAATACTC	FOS
CTGTATCTGACA	NFATC3
ACGCCGGATAAA	JUND
GATAATACTCAG	JUND
TCGTCTGCCACA	CTRL
ACTAATACTTAG	CTRL
CCCACCCAAGCT	EGR1
GGCGCAGCTGAT	BACH2
CTGGTGATCCCN	RELB
TCACAACTCGCC	NFKB1
GAAACTAGCCCG	CTRL
CTATTGTCGTAC	FOS
TTTCCGGTGCAA	PTPN11
CGATAGCGCGCC	DOK2
TATGTGACGAGN	JUND
GTAACCCGTGCC	RUNX2
TATGCGAGAGTN	CTRL
CCTGTCGCGACG	EGR1
GCGCATATGGCG	LAT
ACCGGCATGGGA	NFATC2
ATACACCACAGC	JUND
GCCTGCGTGCTG	NFATC1
ACGACCTCATAG	JUNB
CGGCTTATAAAN	CTRL
GGAGCGTCTAGT	BACH2
GTCACCAGAAGC	PTPN11
CCTAGAGGATCT	LAT
ATTTTGGCGTCA	NFATC3
CTACTTCGTGTA	JUND
CGCTTGAGGCCC	FOS
AACAGTCCGCGC	NFKB1
ACGTCATTTAAT	JUNB
CTTCGAGCACCC	EGR3
GACATGTTTATC	NFKB1
CGCGCCACCGGC	MVD
ACCACAGGTTTA	JUNB
CCCGTCAGTGAN	NFATC2
GCGCCGCTTCGG	CTRL
CGTCGTTGAGGG	BACH2
GTAGCGGGGTTT	CTRL
GCGACTAGCAGA	RELB
TAAATAGGGCCN	NFATC3
CCCATCCTGCCN	NFATC2
TTAACATAGGTC	DOK2
ACGAACATATGG	DOK2
GGTTGGGAGTAC	ZAP70
GAAGGCTGCTGT	RELA
TCACTTGTGGGT	GATA3
CAAATTGTCGCC	NFATC1
CGTCTCGCGAGG	CTRL
TTTTGTATCAAA	EGR3
TGCATAGATGTT	JUN
TAGCAACAATTG	NFKB1
GGTAGAGCAGGC	CTRL
CAGTGGGACCGC	CTRL
AAAGGCCAGTCC	CTRL
GTTATTCTGATC	NFKB2
ATGCTCCTTCGG	FOS
GCACTGTGGCTN	REL
GATGATCAGTTN	NFATC3
CTAAGCGTGACC	FOS
GTATTGTCAAAT	RELB
GCGGATCTTGTT	RELA
ATGTAATATACA	RELB
GACGAGACGGCA	RUNX2
GAGTGAAGTTTG	EGR4
GGGTGCTATGTG	NFAT5
GGTCCGTCTGGC	CTRL
AAAACTAAGTAC	REL
CGCCAATTTCAA	CTRL
ATACGGCAGACA	JUND
TCTTTGACGACC	DOK2
TAGGACTAAAGA	CTRL
GTCCAAACAACC	FOS
GGGTGAAACGTT	JUND
GTAAGAGTTAAA	DOK2
GCATTTCCCCCC	CTRL
GGGGTGCCATTG	PTPN11
ATGGTATTATAC	CTRL
TTCGTGTCCGCG	ZAP70
GTACGATGTGTC	FOS
GCGAGTGGCATN	CTRL
GGTTCCGAGTGA	NFKB2
GAGTGCGGATAC	CTRL
TTTCAGGGCAGG	CTRL
TCTCGAAAACAA	JUNB
AGGAACTTGTTN	DOK2
GATTTTCTTGGC	NFATC1
CATACGCTTGCG	BACH2
GAGACTTGAGCA	REL
TCACAGCTACTN	CTRL
CTTAGAACTACT	FOS
GCATTGTTCGCT	NR4A1
ATGCGAGGTGTG	DHODH
GTGCTATGCGTC	JUND
GCTGACCCTGGT	CTRL
GGCCCTGCTATC	RELA
GGATATATAGCT	NFATC2
TAGTCGCTGTAT	JUNB
GCGCTTGGTCAC	DOK2
GTTAACTTCTTA	JUND
GCAATTACAATC	NFATC3
AGTGAAGGACGG	LCK
CACTAAGTTTTC	NFATC3
GCAACGTGCGGC	NFATC1
AAGGAACCGACG	JUNB
ACAGCGGTTAGN	BACH2
ACCCGGATAATC	DOK2
GCCGCGTATGTG	CTRL
TAGCAGCCCTCN	CTRL
CATTTTGATATA	CTRL
TCCTTACCCAGC	EGR4
TCTTTCGCCCCG	NFKB1
CATTCGCACTCG	GATA3
ATTTAAACATCC	RUNX1
AAATGATGCAGT	CTRL
GCATGGCAACAC	CTRL
TAGGGCCCCATC	MVD
CCTAATCGTCGT	EGR3
ACGTGGGGTCAA	FOS
TATCGACACGAA	NFKB1
GGGCATCGCTCC	LAT
TTCAAAGCTTAG	EGR3
CCCAAAAGTGTA	CTRL
GGGTCGAAGTTA	MVD
TGGAATAAGTAA	REL
GTGCGCACTTAC	NFKB1
GATACAAGTGTA	DHODH
GTCGCCACGACC	JUNB
AGTATCTAAAGG	NFATC1
GCCTTCTGACTT	CTRL
TAATAATTGACC	NFKB2
TGGCTGAGCTTG	ZAP70
ATATTGCTAGCG	BACH2
AAAGGAGAAAAC	FOS
TCACGTCGCTTC	RELA
AAGTAGTAACTC	EGR3
GTTCTATCAGTA	JUND
ACAAGGGTAGAC	NFATC1
TGTATACCGGCT	PTPN11
CTCTCATTAACC	CTRL
ATTCTACATGAC	NFATC1
TGAGGGTAAAGA	JUN
CTGGGCTTGCTA	CTRL
GTTTTGCTGATG	CTRL
TGGTCGCTTCAA	CTRL
CAAGCCGGACGA	RUNX2
ACTTGGTTTAGA	NFKB1
TTTGCCGCAAGT	EGR1
CTAATACAGACT	PTPN11
CGTATTCGCGAG	EGR2
GTACGGCGTTAG	LAT
CTACCTTGCCCG	CTRL
TTACTGGGATAC	PTPN6
GACGTGTAACTC	RUNX2
GGCCGTGAGTAG	PTPN6
TCCTTGTGGGTN	GATA3
TCCGCGGTTGCN	LCK
ACGCATCTTTAA	CTRL
TGAGATAAGAGA	BACH2
TGAGGAGGCATC	JUNB
AGGTTGTTGGGA	NFATC1
GCTTCAGCTAGA	CTRL
GCGCCGAAGCAA	NFATC2
TATCTTCCCCAG	DOK2
CTATCAATAAAG	MVD
CCGGTGTGGTCN	CTRL
AAACGGTGTTGG	RUNX1
CTACCTTGACCG	CTRL
TATCACCGTAAT	EGR3
CTACCTAACCGC	MVD
GTCAAAGTAGAC	BACH2
TCGTTAACTATT	REL
CTTCGATTTCCC	EGR1
ACATATATCCGG	REL
AACCTCGCTATC	RUNX2
GATGGCAGACGN	NFAT5
CAACCCACTTCN	CTRL
GCTTAGTTTAGC	EGR2
CAGAAAACTACT	RUNX2
TAGCGCGCGGAA	ZAP70
TAGACTCGCGTG	EGR1
GGGGTATCTAAA	NFKB2
AGGATCGTACGT	ZAP70
CCTGGACTTTNN	RUNX2
ATCGTTATCGTA	RELA
CCCTTTAAAAAA	RELB
ACCCACCCTTCC	NFKB1
GAGTAATCCTTC	LAT
CCTTCATCCGTC	NFKB2
CTCCTGATACGG	NFKB1
TGTGGACGGGCA	GATA3
CTAAATATGCAC	RUNX2
AGTCAAGTAGTT	LAT
CCACCACAAACT	REL
GGAGGGGGGCAG	LAT
GTCTAGGTTCAA	BACH2
CCCTACCGGAAG	NFKB1
AGGCAATGGAGC	DOK2
TCGCGGTTGGCC	RELA
GCGCCGACTCTA	PTPN6
CTCTGTGAGTGG	JUN
AACTCTTGATCA	NFAT5
AGTGATCGGCAT	JUNB
CATTTGGCCTAG	CTRL
AACTATTGGGGN	ZAP70
CGCGGCAACCGT	NFATC3
TGAGGGATGACA	MVD
ACTACGACCCGA	DHODH
TAGTCTTAAAGC	PTPN11
ACCTTAGGTGCC	NR4A1
GAGCCTCTTGTT	CTRL
TACTTTCGCTAG	CTRL
GGCGATTTCCCA	LAT
GTGCCTACTTCC	BACH2
AAAATTCTAACC	CTRL
CGCGCTACATCC	CTRL
CACGCGTGTCAC	EGR2
TCACAAAACGTA	PTPN11
GTATACGACATA	CTRL
TGCACAGCTACT	CTRL
CAAACTCCAAGC	NFATC3
GAACGTGGAAGG	LAT
TGCATGCCGAGC	RELB
CTTCTCCGTAAC	LCK
GTGGTTACGGCN	CTRL
TAGTGGGCAACT	NFATC2
AGACTGGCTGCC	NFAT5
CCCATGCGTAGG	JUND
GCGGTCGCACAA	NFATC1
TTTCAAGAAAGG	CTRL
AGCGCACTCTAA	FOS
AAAAGCATGAAA	EGR4
CGCATGAGAACT	PTPN6
TAAGATGCTGCG	CTRL
GACTAGTAAGAG	RUNX2
GGCAGTGTGGCG	LAT
AGCCGCAGGCGN	CTRL
TAGAGTACCCCN	JUN
ACCGTAAGACAG	CTRL
GAGGAAGATCAA	NFKB1
GGCTGGCAATGT	EGR3
CTAAAGCGGCCN	CTRL
AGCAGCCGGGAT	CTRL
TTGGTTGCCGAC	EGR2
TTGGTTGCCGCC	EGR2
TGCGACGACCGA	EGR2
CTGTTTATCCCT	JUN
ACGGTCTGGCCC	CTRL
AGTGTTATATTA	REL
GCCGGCATGGGA	NFATC2
TGCCCAGCCAAG	DOK2
AATTGTCGACCA	JUNB
TAGAGGTAGGAC	JUNB
AATCAACCCAAA	NFATC1
TCGAGGACTTAA	ZAP70
GGACATACGAGC	LAT
ATTTTATACTGT	JUNB
AGTGGTACACGG	FOS
GCTGATATCTAG	CTRL
GAGCTTATACTT	CTRL
GCAGTGGGTGAC	CTRL
CAGTCAGTTAAN	JUND
GCGGGTTGAACC	EGR3
CTTGACTACTTC	NFKB2
GACCTTCATAAC	NFATC2
CGGTCCCCGTGA	REL
GCTGGAGCGGCN	ZAP70
CGAAATATGGGT	ZAP70
ACTCTCGCGTAA	RELB
TCTGAGCTGGGC	EGR4
TCTAACTAAAGT	CTRL
TGTCGTCGCGAC	CTRL
ACAGGTAAGGCC	JUN
GGTGACTGGTCA	BACH2
GACGGGAAACAT	PTPN11
GTGAGGGCGTGG	JUNB
TTGCCACTGGCG	CTRL
TCGTTTGGACCA	RELB
GGCTCCTGTGGT	EGR2
TGTGGGACGATA	LAT
CTAGCGCCATTA	BACH2
AGATCGCAGTCA	JUNB
TGTGTATATTTG	PTPN11
TCCCGCAGTCGC	NFKB2
CGCGTTGTGATG	JUN
GTGCTCCTTCGG	FOS
ATGGCCGTCGTG	NFATC1
TACCCCATACAC	ZAP70
CAGATCCGTCTC	NFKB2
GCTGTGCCGGAN	RELB
CCTGTTGACATC	CTRL
TTCCATCACTAC	BACH2
AGGTATGATCTG	CTRL
TGGTTGGTTCCT	CTRL
AGGCTTGGTGAG	NFAT5
CCCTGGACTTTN	RUNX2
GCAATTACTTGN	CTRL
GAGGCCGCCATT	MVD
AAGACTAGACTC	CTRL
TCTCGAGTCTAC	CTRL
GCAACATCTCGA	ETS1
CGGGGCAAAATT	RUNX1
ATAACACACTGA	EGR2
GGCGGTTATGCC	BACH2
CAGCTGCCACCA	NR4A1
GTCGATCGCGCA	NFATC3
AATGCCGTCCGG	NR4A1
GACATCCCCGCC	BACH2
ACCCGTTGGCTG	RUNX2
ATCGTATCCGCC	DOK2
CGGAGGGCTGAN	FOS
TTACATCTTACA	CTRL
GGGAGACGGCGG	FOS
CTCCGCGGTACC	EGR4
CTTATTGTATTC	NFKB1
CACGGCGCTTTG	NR4A1
CCAACCCACTTC	CTRL
TGGTTGCATGNN	NFATC2
GCAGAGCATTTA	CTRL
ATGAAAATTATC	EGR1
CTCCTAAGGTAA	EGR1
CTGCATGGCTCC	JUNB
GCGGACTATAGA	CTRL
TGGCGTAGTAAC	JUND
AAGACATAAGTG	ZAP70
ACGTTAGCCGAC	EGR1
ATCGGTTGGCGA	EGR3
TTTTCTCTTCTA	PTPN11
TTCCAGACCGAA	JUNB
TGTTTAAGTTAN	PTPN11
GGAATCGACACG	NFATC1
AGGTCGCTCAGG	CTRL
TTATACGACAAC	CTRL
GGGGCGCCACCT	CTRL
GCCCGGATAATC	DOK2
TGTCGCTAATGC	CTRL
CCGACCGGCGCT	NFKB2
GTTCGCAGATGC	DOK2
GCAGGCGATTNN	EGR4
CGGGAACTAGAC	REL
TTTTTGGCGTCA	NFATC3
TGTACGGCTGTG	BACH2
AATCGTCCTACC	RUNX1
TTTCCTCACGCA	EGR3
TGTGAAATGTGC	BACH2
GCATGGGGGACG	CTRL
TCGGGTCGCCGC	CTRL
GGTACACAGAAA	EGR2
TAGTGGAAAGAG	EGR4
CCTTTGTTATCC	BACH2
AACAACCCGGGG	JUNB
GCATCGTTCTTN	CTRL
TAGTATAGCTTC	CTRL
TACCCATTGGAC	PTPN11
TGATTCGATAGG	RELB
AGGGTGAGTTAC	RELA
GAGGACGACTGA	JUNB
GTATAATCTNNN	NR4A1
ACTCTTAGCCGA	CTRL
AAGGACAATGAC	EGR3
GGGAACACCGTC	NFKB2
TGTCTCGACCGN	RUNX2
TACTAACATTGT	BACH2
CTATCCTCCCTN	CTRL
GCTTGTTCTGGT	CTRL
GACAGGGAGCCG	RUNX2
CTCGTAAATTGT	NFATC1
TCGTATTACGGC	LCK
TGGTCTTTACCG	RUNX2
AGGACGCAGTGT	EGR3
TTACATGCTATA	BACH2
CCCGTCATCGAG	ZAP70
GTCCACCTTTAN	NFATC1
TTGGACCGGCGN	NFKB2
ACCGGATCGTTA	CTRL
AGACACAGGCAC	LCK
CACTACGGCATA	CTRL
ATTAGCGTATAA	JUND
TCAAGCACCCCA	NR4A1
AAGGTTTCCAGA	NFATC3
CCTTTACTTGCC	NR4A1
CGGACTTTAGTC	JUN
GGCTCGGGGAAC	LCK
CCGGCGGCTCTT	CTRL
AGGACAGTTTCG	DOK2
GCCCACCCTTCC	NFKB1
GATAAACAGTCC	CTRL
ACAAACGGGCTA	GATA3
GTCAAGATGCGG	EGR1
GGCGATTTTACC	CTRL
CTATTGGACATA	FOS
CCCAACGACACC	CTRL
TCGGTATCAGAN	CTRL
CTCGCTCGTTTN	LAT
TGTGCCGCTGTC	LCK
CCGGATGGGCTA	REL
AAACACCTATTC	DOK2
TAATTTTTGAAT	CTRL
TGCCTGCCGAGC	RUNX2
TGGTGTAGCTTT	NFATC2
TTAATCGAGCGG	ZAP70
GTGAGGAAGTAA	FOS
AGCAGACTAATA	CTRL
GTTAAGTAGTAN	CTRL
CTGTCTCCGGCT	EGR3
CATCGCTTATTC	JUND
TTACAGTATACT	LCK
CAGACTCTCCGC	NFKB2
TCAATTGATTAA	FOS
CTGCCTAGATTT	NFKB2
TGATATAGATAT	FOS
TTTTTTATGATA	NFATC1
GTTCAAATATCA	CTRL
CCTTACCACTTT	NR4A1
ACGGTACTGCAT	NR4A1
GCTCGAAGAGNN	EGR1
TAGACCTATCAT	FOS
AGTTGTCAAGTT	FOS
AATCAGGTCGGC	ZAP70
AGGTAGACCCCN	CTRL
GCTACGACCCGA	DHODH
TAGGTGTACACN	CTRL
CCATACGACCGG	CTRL
CCACTATGAGCG	NFKB2
TGAGGTGTACAC	CTRL
TAGCGTCGAAGG	PTPN11
GTAGATTTAGTC	FOS
ATGACGGGCTAN	CTRL
GGGCTGGTACAA	ZAP70
CCTCTCAAAGCT	RELB
ATAGAGCATTGA	NFATC2
TTGTCTCGACCG	RUNX2
AGAATTTGGCAG	CTRL
AAAGGCCTTGNN	CTRL
AGGAGTGGTACA	GATA3
AGTATCGGTGAA	JUND
GAAGAGGCTGTT	PTPN11
GTACAATTTCCA	BACH2
GTAAGCCTACCG	PTPN6
TATGAATAGATG	PTPN6
GTGGTTAATCCA	BACH2
TTGATTCGAAAT	CTRL
TTTTAAACAGCT	RELB
CCCTAACTGCTG	LCK
AACTATATGTAT	NR4A1
CGATATAAGGTC	BACH2
CCGGTTCGGACG	EGR4
GTGTGACTATTC	EGR2
GACGGGGTCGCC	RUNX1
GCTCGCGTCAGG	RELB
ACGGGCAGTTTN	NFAT5
ATGGTTGGGACA	RUNX2
CATTATATATGT	NFATC1
ACATCCTGACAG	CTRL
CATATTTGTTCT	EGR1
GGCAGCCGGGAT	CTRL
TCTTCGACTGCA	CTRL
AGGTCGACAGAT	NFATC1
ATATCGTTACGG	ZAP70
ATTCATCGGGCA	CTRL
GACCTGGTGCTN	DOK2
AGGTCGACAATN	NFATC1
AAGAAAAGATAT	EGR4
GCTGCAGTCCTN	CTRL
CCATTCCAATGG	EGR1
ACCGAGTCTCTA	PTPN11
TAAGCAAACGCA	NR4A1
ATCGCGCGCTTG	PTPN11
TTACTCGGTCTC	RELA
CTGTCTTAAAGC	CTRL
CAACAGACAGAN	CTRL
CACTCGACAACG	NR4A1
GTCCTCTAACCT	NFKB1
GTCGTCGGTTCN	EGR3
GGGCCCAGGTAN	REL
AAAAAGGTAATC	RUNX2
GATGACGTCGTC	FOS
GCGCCCTCGCGC	NFAT5
GGCCCCACCTCG	LAT
ACAGGGGACCGC	NFKB1
CTGGACCATCAT	RELA
AACGAACGGATG	LCK
ACACCGGGGTGC	BACH2
ATCTCAATACTC	FOS
TGGAACGAATAC	CTRL
GTGTCAGCGCTA	RELA
GCTTGATAACAA	NFAT5
AATAGGATGCAG	PTPN11
TGATTTTGCTAA	EGR2
TCTGGATTTCGA	NFKB1
